Name,SellPrice,BuyPrice,AvgSellPrice,AvgBuyPrice,Sold,Bought,Profit,RelProfit,PotProfit
25 years backpack,2100000,1150030,1623356,836082,33,22,949970,0.83,20899340
abacus (replica),-1,-1,-1,-1,-1,-1,0,0,0
abomination's eye,-1,0,0,0,0,0,-1,0,0
abomination's tail,-1,0,0,0,0,0,-1,0,0
abomination's tongue,50000,50000,0,0,0,0,0,0.0,0
abyss hammer,21897,19680,22856,19506,8,138,2217,0.11,17736
abyssador's lash,79900,25005,118701,54607,47,28,54895,2.2,1537060
acid resistant fishing rod,500,1,572,1,5,8,499,499.0,2495
acorn,1799,1401,1881,1205,579,1027,398,0.28,230442
adventurer's map,-1,-1,-1,-1,-1,-1,0,0,0
afflicted strider head,676,676,0,400,0,5,0,0.0,0
afflicted strider worms,276,276,0,224,0,8,0,0.0,0
albino plate,980000,400200,978616,400453,5,4,579800,1.45,2319200
alchemist's boots,42222222,85000000,72250000,85000000,4,1,-42777778,-0.5,-42777778
alchemist's notepad,44999999,35000000,42499999,38500000,2,2,9999999,0.29,19999998
alicorn headguard,272999,235000000,266382833,251618631,18,19,-234727001,-1.0,-4225086018
alicorn quiver,177499,152000000,175866922,159341200,13,10,-151822501,-1.0,-1518225010
alicorn ring,100002,135022000,0,136348000,0,3,-134921998,-1.0,0
alloy legs,10672,8940,10916,9188,85,198,1732,0.19,147220
almanac of magic,3200,85,2704,119,136,9,3115,36.65,28035
alptramun's toothbrush,209000,209000,0,235900,0,2,0,0.0,0
amarie's favourite book,-1,10000,0,10000,0,1,-10001,-1.0,0
amazon armor,12700000,12700000,0,0,0,0,0,0.0,0
amazon disguise kit,200000,55000,750000,55000,1,1,145000,2.64,145000
amazon helmet,150000,150000,0,0,0,0,0,0.0,0
amazon shield,15100000,15100000,0,0,0,0,0,0.0,0
amber (item),-1,-1,-1,-1,-1,-1,0,0,0
amber staff,8000,7901,8070,7898,12,919,99,0.01,1188
amber with a bug,47900,40091,66700,40351,2,16,7809,0.19,15618
amber with a dragonfly,79900,54281,107968,54561,3,22,25619,0.47,76857
amethyst necklace,101457,350000,0,350000,0,1,-248543,-0.71,0
amphora,1,0,1,0,1,0,1,0,0
amulet of loss,51998,49800,51892,49385,2224,604,2198,0.04,1327592
amulet of theurgy,999890,802000,1143956,916333,50,56,197890,0.25,9894500
anatomy book,-1,-1,-1,-1,-1,-1,0,0,0
ancient amulet,1600,10,3331,752,3,8,1590,159.0,4770
ancient amulet (quest),-1,-1,-1,-1,-1,-1,0,0,0
ancient belt buckle,-1,-1,-1,-1,-1,-1,0,0,0
ancient coin,375,278,382,272,5,192,97,0.35,485
ancient liche bone,29900,27381,28363,26674,6,117,2519,0.09,15114
ancient map,-1,-1,-1,-1,-1,-1,0,0,0
ancient shield,526,526,872,546,43,267,0,0.0,0
ancient stone,174,125,182,134,11,304,49,0.39,539
ancient tiara,2625457,5000000,0,5000000,0,1,-2374543,-0.47,0
ancient watch,340,2310,0,2382,0,5,-1970,-0.85,0
angel figurine,35581,35370,36611,33687,2,121,211,0.01,422
angelic axe,4950,4338,4818,4155,33,198,612,0.14,20196
animal cure,2696,2,2678,150,89,2,2694,1347.0,5388
animal fetish,990,0,1197,0,6,0,990,0,0
animate dead rune,36,1,38,4,69,15,35,35.0,525
ankh,138,70,233,79,87,370,68,0.97,5916
annihilation bear,100000,100000,66287,41220,12,10,0,0.0,0
anniversary backpack,369999,203407,370645,284696,34,37,166592,0.82,5664128
anniversary cake,100000,11100,128900,0,1,0,88900,8.01,0
antidote potion,1999,1000,6332,1000,6,4,999,1.0,3996
antler talisman,-1,10000,0,10000,0,1,-10001,-1.0,0
antler-horn helmet,40000000,40000000,57500000,40000000,2,1,0,0.0,0
antlers,1999,31,2509,56,28,15,1968,63.48,29520
ape fur,18091,16051,18768,15341,476,509,2040,0.13,971040
apron,433,433,0,823,0,6,0,0.0,0
arbalest,45000,36222,43349,31284,35,28,8778,0.24,245784
arboreal crown,45999000,40000000,44983823,43109454,17,11,5999000,0.15,65989000
arboreal ring,12700000,112000000,132465000,119520000,4,4,-99300000,-0.89,-397200000
arboreal tome,92011000,92011000,98740583,93942538,24,13,0,0.0,0
arcane staff,43355,27813,42098,31958,33,56,15542,0.56,512886
arcanomancer folio,89000000,80023000,98145262,90932083,19,12,8977000,0.11,107724000
arcanomancer regalia,57000000,50056000,60510113,57170653,21,16,6944000,0.14,111104000
arcanomancer sigil,119000,96002000,0,98012000,0,4,-95883000,-1.0,0
arena badge,300000,23000,324999,67392,2,3,277000,12.04,554000
armor rack kit,100000,100000,0,0,0,0,0,0.0,0
arrow,-1,1,3,1,295,202,-2,-2.0,-404
artist's brush,130200,130200,0,0,0,0,0,0.0,0
artist's brush (with paint),-1,-1,-1,-1,-1,-1,0,0,0
artist's canvas,499999,245410,499999,0,3,0,254589,1.04,0
artist's palette,44900,501,54900,2550,2,4,44399,88.62,88798
assassin dagger,20729,19880,20339,19685,51,1233,849,0.04,43299
assassin star,-1,3,18,11,828,1678,-4,-1.33,-3312
astral glyph,1000000,1000000,0,0,0,0,0,0.0,0
astral shaper rune,4243000,2444555,4758140,3362857,7,10,1798445,0.74,12589115
astral source,2000000,100500,2000000,0,1,0,1899500,18.9,0
atlas,2990,100,3868,100,78,3,2890,28.9,8670
aubergine,-1,0,0,0,0,0,-1,0,0
avalanche rune,58,56,57,56,5204,985,2,0.04,1970
avalanche rune (weak),-1,-1,-1,-1,-1,-1,0,0,0
axe,4950,4338,4818,4155,33,198,612,0.14,20196
axe of carving,-1,-1,-1,-1,-1,-1,0,0,0
axe of destruction,1784993,450100,1552074,769260,9,8,1334893,2.97,10679144
axe of mayhem,-1,-1,-1,-1,-1,-1,0,0,0
axe of remedy,-1,-1,-1,-1,-1,-1,0,0,0
axe ring,532,367,479,344,868,512,165,0.45,84480
babel swimmer,-1,0,0,0,0,0,-1,0,0
baby rotworm,988,35,1135,42,103,8,953,27.23,7624
backpack,2100000,1150030,1623356,836082,33,22,949970,0.83,20899340
backpack of holding,163999,136813,145495,116523,358,258,27186,0.2,7013988
badbara,313313,180100,290876,172667,10,3,133213,0.74,399639
badger boots,7444,6881,7285,6623,59,707,563,0.08,33217
badger fur,34,1,146,4,3,109,33,33.0,99
badger fur (decoration),-1,-1,-1,-1,-1,-1,0,0,0
bag,-1,0,0,0,0,0,-1,0,0
bag (ahmet),-1,-1,-1,-1,-1,-1,0,0,0
bag of apple slices,99,5,321,54,379,276,94,18.8,25944
bag of oriental spices (replica),-1,-1,-1,-1,-1,-1,0,0,0
bait,1000,0,313,0,19,0,1000,0,0
baking tray,10000,10000,0,0,0,0,0,0.0,0
baking tray (cookie),-1,-1,-1,-1,-1,-1,0,0,0
baking tray (reed),-1,-1,-1,-1,-1,-1,0,0,0
bale of white cloth,-1,0,0,0,0,0,-1,0,0
bale of yellowed cloth,10000,10000,0,0,0,0,0,0.0,0
bamboo drawer kit,100000,100000,0,0,0,0,0,0.0,0
bamboo leaves,479,180,454,225,352,208,299,1.66,62192
bamboo stick,589,12,886,12,8,23,577,48.08,4616
bamboo table kit,100000,100000,0,0,0,0,0,0.0,0
banana,87,1,85,1,41,76,86,86.0,3526
banana chocolate shake,200,50,521,55,18,65,150,3.0,2700
banana sash,89,19,115,23,11,114,70,3.68,770
banana skin,87,1,247,1,49,46,86,86.0,3956
banana staff,261900,65000,103288,56524,73,18,196900,3.03,3544200
bandana,190,101,464,99,2,84,89,0.88,178
bar of chocolate,5785,3459,6514,4925,85,266,2326,0.67,197710
bar of gold,33333,11002,45332,21501,92,119,22331,2.03,2054452
barbarian axe,198,10,217,7,21,34,188,18.8,3948
bark peeler,5000,16,5833,8,3,6,4984,311.5,14952
barrel kit,100000,100000,0,0,0,0,0,0.0,0
barrel of beer,20000,20000,0,0,0,0,0,0.0,0
basalt fetish,-1,-1,-1,-1,-1,-1,0,0,0
basalt figurine,-1,-1,-1,-1,-1,-1,0,0,0
bashmu fang,203,203,0,362,0,17,0,0.0,0
bashmu feather,-1,253,0,264,0,26,-254,-1.0,0
bashmu tongue,319,319,0,313,0,29,0,0.0,0
basket,1000000,305100,999999,0,2,0,694900,2.28,0
basket (puppies),-1,-1,-1,-1,-1,-1,0,0,0
bast legs,1680000,705763,1429992,702042,6,1,974237,1.38,974237
bast skirt,49918,15200,37648,13514,41,20,34718,2.28,694360
bat decoration,3999,1520,3873,1496,4,24,2479,1.63,9916
bat wing,143,47,176,39,184,489,96,2.04,17664
battle axe,150,52,137,31,27,94,98,1.88,2646
battle hammer,180,92,775,59,12,103,88,0.96,1056
battle shield,90,23,85,28,19,112,67,2.91,1273
battle stone,618,156,559,219,182,443,462,2.96,84084
batwing hat,8790,7790,9195,7787,89,81,1000,0.13,81000
beach backpack,487,29,697,15,296,176,458,15.79,80608
beach bag,549,0,589,0,50,0,549,0,0
bear doll,25999999,23000000,26050000,23000000,2,1,2999999,0.13,2999999
bear paw,287,212,333,180,262,619,75,0.35,19650
bear skin,124987,83700,100058,73816,150,106,41287,0.49,4376422
beast's nightmare-cushion,609000,609000,0,596266,0,17,0,0.0,0
beastslayer axe,1543,1465,1636,1415,28,733,78,0.05,2184
bed of nails,948,437,507,434,11,588,511,1.17,5621
beer bottle,2500,0,2498,0,10,0,2500,0,0
beer mug,155555,155555,0,0,0,0,0,0.0,0
beetle carapace,199,66,182,92,2,81,133,2.02,266
beetle necklace,2500,1254,2720,1768,320,213,1246,0.99,265398
beetroot,-1,0,3,0,10,0,-1,0,0
behemoth claw,2169,1750,2073,1727,43,146,419,0.24,18017
behemoth trophy,19800,15020,19416,15927,12,64,4780,0.32,57360
belted cape,498,229,447,183,102,389,269,1.17,27438
berserk potion,494,490,493,484,432,3459,4,0.01,1728
berserker,50000,37209,40777,37115,18,34,12791,0.34,230238
bestiary betterment,2893996,2305000,2860287,2271546,53,32,588996,0.26,18847872
big table kit,-1,0,0,0,0,0,-1,0,0
bill,-1,0,0,0,0,0,-1,0,0
birdcage kit,100000,100000,0,0,0,0,0,0.0,0
birthday backpack,96500,40044,95767,45154,56,48,56456,1.41,2709888
birthday cake,7900,1021,8041,925,12,19,6879,6.74,82548
birthday card,38999,212,53333,606,3,2,38787,182.96,77574
birthday cup,0,0,0,0,0,0,0,0,0
black hood,-1,101,0,105,0,48,-102,-1.01,0
black jade cobra,99,0,113,0,5,0,99,0,0
black pearl,297,275,366,258,77,1476,22,0.08,1694
black pit demon,350000,1200000,0,1200000,0,1,-850000,-0.71,0
black raven kit,4500001,4500001,0,0,0,0,0,0.0,0
black shield,590,471,690,457,32,438,119,0.25,3808
black skull (item),-1,-1,-1,-1,-1,-1,0,0,0
black wool,1500,1500,5000,1005,1,1,0,0.0,0
blacksteel sword,7500,5921,10057,5921,23,21,1579,0.27,33159
blade of carving,-1,-1,-1,-1,-1,-1,0,0,0
blade of corruption,59900,44522,61305,38817,17,15,15378,0.35,230670
blade of destruction,444436,383000,572258,462061,16,12,61436,0.16,737232
blade of mayhem,-1,-1,-1,-1,-1,-1,0,0,0
blade of remedy,-1,-1,-1,-1,-1,-1,0,0,0
bladespark figurine,170000,12500,161999,30017,2,2,157500,12.6,315000
blank poetry parchment,-1,0,0,0,0,0,-1,0,0
blank rune,11,10,11,10,947,330,1,0.1,330
blazing bone,1989,1401,2240,1480,642,301,588,0.42,176988
blemished spawn abdomen,356,356,0,329,0,11,0,0.0,0
blemished spawn head,701,701,0,678,0,9,0,0.0,0
blemished spawn tail,676,676,0,490,0,7,0,0.0,0
blessed acorn,500,500,10000,500,1,4,0,0.0,0
blessed ankh,-1,0,545,0,3,0,-1,0,0
blessed sceptre,59999,31036,63300,33995,6,2,28963,0.93,57926
blessed shield,1999999,1999999,0,0,0,0,0,0.0,0
blessed steak,909489,860215,919659,861146,293,103,49274,0.06,5075222
blessed wooden stake,57499,39095,46568,35557,170,158,18404,0.47,2907832
blood goblet,9495,7589,9372,7189,6,41,1906,0.25,11436
blood herb,15489,10093,15832,10291,131,73,5396,0.53,393908
blood of the mountain (item),-1,-1,-1,-1,-1,-1,0,0,0
blood preservation,300,281,311,252,15,369,19,0.07,285
blood skull,1200000,125000,4999999,0,1,0,1075000,8.6,0
blood tincture in a vial,395,205,404,241,35,187,190,0.93,6650
bloodkiss flower,11400,63,11244,62,7,3,11337,179.95,34011
bloody dwarven beard,300,40,300,62,1,36,260,6.5,260
bloody edge,37967,20001,31354,15943,15,35,17966,0.9,269490
bloody pincers,6500,5703,7135,6624,2505,920,797,0.14,733240
bloody tears,95000,71000,93333,71000,3,8,24000,0.34,72000
blossom bag,375000,255001,355969,245962,91,79,119999,0.47,9479921
blue and golden cordon,0,1600,0,1600,0,1,-1600,-1.0,0
blue backpack,450,5,377,20,460,286,445,89.0,127270
blue bag,800,1,717,1,51,4,799,799.0,3196
blue bed kit,-1,-1,-1,-1,-1,-1,0,0,0
blue crystal shard,1496,1482,1498,1478,4,1234,14,0.01,56
blue crystal splinter,395,395,449,392,2,359,0,0.0,0
blue fireworks powder,399,16,545,11,41,82,383,23.94,15703
blue fireworks rocket,-1,-1,-1,-1,-1,-1,0,0,0
blue gem,4995,4955,4988,4951,19,3816,40,0.01,760
blue gingerbread heart,150000,150000,0,0,0,0,0,0.0,0
blue glass plate,70,40,86,33,35,151,30,0.75,1050
blue goanna scale,450,206,336,194,12,559,244,1.18,2928
blue legs,120897,48401,129798,115903,174,144,72496,1.5,10439424
blue piece of cloth,419,335,560,289,279,343,84,0.25,23436
blue pillow,188,1,150,1,2,12,187,187.0,374
blue pit demon,666000,50001,950000,50001,1,1,615999,12.32,615999
blue powder,10000,10000,0,0,0,0,0,0.0,0
blue quiver,499,100,624,96,333,88,399,3.99,35112
blue robe,10000,9530,10049,9512,255,1129,470,0.05,119850
blue rose,1688,15,4486,55,12,22,1673,111.53,20076
blue sphere,40000000,40000000,89997000,0,1,0,0,0.0,0
blue tapestry,99,1,120,1,1,1,98,98.0,98
blue tome,45000000,45000000,0,0,0,0,0,0.0,0
blueberry,99,0,49,0,11,0,99,0,0
blueberry cupcake,884000,791301,884238,772128,482,177,92699,0.12,16407723
boar man hoof,100,501,0,501,0,10,-401,-0.8,0
boggy dreads,280,141,494,120,8,147,139,0.99,1112
bola,40,26,66,23,5,221,14,0.54,70
bolfrim's golden bug trophy,499999,60000,544666,0,1,0,439999,7.33,0
bolt,-1,1,3,1,98,213,-2,-2.0,-196
bone,29900,27381,28363,26674,6,117,2519,0.09,15114
bone club,3780,0,3799,0,1,0,3780,0,0
bone fetish,101,101,0,91,0,88,0,0.0,0
bone fiddle,2497999,1850102,2082924,1796170,165,138,647897,0.35,89409786
bone shield,100,3,143,46,3,98,97,32.33,291
bone shoulderplate,214,147,4,102,141,125,67,0.46,8375
bone sword,10,4,8,4,7,37,6,1.5,42
bone toothpick,142,52,141,85,3,73,90,1.73,270
bonebeast trophy,5500,4186,5600,4057,19,122,1314,0.31,24966
bonebreaker,9990,8302,9691,8528,30,598,1688,0.2,50640
bonecarving knife,-1,-1,-1,-1,-1,-1,0,0,0
bonelord eye,4777,3402,5412,4651,347,308,1375,0.4,423500
bonelord helmet,7299,6170,7268,5831,12,30,1129,0.18,13548
bonelord shield,1088,920,1257,843,48,93,168,0.18,8064
bones (item),-1,-1,-1,-1,-1,-1,0,0,0
bones of zorvorax,9610,9610,0,4832,0,4,0,0.0,0
bonfire amulet,10000,10000,0,0,0,0,0,0.0,0
bongo drum,100,100,0,0,0,0,0,0.0,0
bony tail,215,154,205,177,9,566,61,0.4,549
book (cgb),-1,-1,-1,-1,-1,-1,0,0,0
book backpack,199797,125370,244261,147323,34,35,74427,0.59,2530518
book of lies,1270000,3500000,0,3500000,0,1,-2230000,-0.64,0
book of necromantic rituals,200,164,175,157,17,455,36,0.22,612
book of orc language,200000,50000,391999,125000,4,2,150000,3.0,300000
book of prayers,500,65,462,58,4,69,435,6.69,1740
book page,1000,569,1246,566,3,65,431,0.76,1293
bookcase kit,-1,0,0,0,0,0,-1,0,0
boots of haste,30099,29950,30188,29800,1809,2366,149,0.0,269541
boots of homecoming,39885,15000,102226,24266,167,67,24885,1.66,1667295
boots of homecoming (used),-1,-1,-1,-1,-1,-1,0,0,0
boots of renewal,-1,-1,-1,-1,-1,-1,0,0,0
boots of waterwalking,496,496,0,0,0,0,0,0.0,0
botany almanach,20000,20000,0,0,0,0,0,0.0,0
bottle,2500,0,2498,0,10,0,2500,0,0
bottle of bug milk,-1,-1,-1,-1,-1,-1,0,0,0
bottle of glooth wine,-1,1500,5000,1500,1,1,-1501,-1.0,-1501
bottle of tibian wine,8479,222,8619,875,22,39,8257,37.19,181654
bottle of whisper beer,1599,0,2327,0,58,0,1599,0,0
bow,122,40,118,48,73,147,82,2.05,5986
bow of carving,-1,-1,-1,-1,-1,-1,0,0,0
bow of cataclysm,2144000,1586003,2407374,1969366,42,48,557997,0.35,23435874
bow of destruction,335000,235919,335234,242138,23,17,99081,0.42,1684377
bow of mayhem,-1,-1,-1,-1,-1,-1,0,0,0
bow of remedy,-1,-1,-1,-1,-1,-1,0,0,0
bowl,9949,0,7193,0,4,0,9949,0,0
bowl (gold),-1,-1,-1,-1,-1,-1,0,0,0
bowl (green),-1,-1,-1,-1,-1,-1,0,0,0
bowl (silver),-1,-1,-1,-1,-1,-1,0,0,0
bowl of evergreen flowers,2040,1,2171,2,118,2,2039,2039.0,4078
bowl of glooth soup,-1,2,11,2,7,43,-3,-1.5,-21
bowl of terror sweat,182,182,0,344,0,5,0,0.0,0
bowl with sacred water,20000,20000,0,0,0,0,0,0.0,0
bracelet of strengthening,47000000,55000000,58724750,55000000,4,1,-8000000,-0.15,-8000000
brain head's brain,10000,10000,0,0,0,0,0,0.0,0
brain head's giant neuron,60001,60001,0,0,0,0,0,0.0,0
brain head's left hemisphere,45001,45001,0,0,0,0,0,0.0,0
brain head's right hemisphere,26001,26001,0,0,0,0,0,0.0,0
brain in a jar,369614,220200,450323,294958,49,33,149414,0.68,4930662
brainstealer's brain,290900,290900,0,254372,0,10,0,0.0,0
brainstealer's brainwave,153000,153000,611100,139000,2,1,0,0.0,0
brainstealer's tissue,245000,230900,232500,222225,2,44,14100,0.06,28200
branch (quest),-1,-1,-1,-1,-1,-1,0,0,0
brass armor,999,105,159,91,96,344,894,8.51,85824
brass helmet,-1,1,20,6,1,22,-2,-2.0,-2
brass legs,90,18,128,16,40,203,72,4.0,2880
brass shield,-1,4,49,4,5,11,-5,-1.25,-25
bread,150000,150000,0,0,0,0,0,0.0,0
bricklayers' kit,1339,0,1023,0,13,0,1339,0,0
bright bell,3999,146,2749,144,3,90,3853,26.39,11559
bright sword,60000,31200,62360,31972,40,17,28800,0.92,489600
brimstone fangs,12988,10107,14536,11532,596,330,2881,0.29,950730
brimstone shell,249,181,338,129,110,143,68,0.38,7480
broadsword,450,301,391,207,45,348,149,0.5,6705
brocade backpack,94,25,85,14,648,338,69,2.76,23322
brocade bag,800,1,5469,218,33,14,799,799.0,11186
broccoli,0,100,0,100,0,5,-100,-1.0,0
broken amulet,250000,520000000,0,520000000,0,1,-519750000,-1.0,0
broken crossbow,19,19,0,16,0,155,0,0.0,0
broken draken mail,0,50,0,223,0,36,-50,-1.0,0
broken dream,90,0,246,0,7,0,90,0,0
broken gladiator shield,172,122,172,109,9,291,50,0.41,450
broken halberd,140,65,242,81,4,147,75,1.15,300
broken helmet,33,1,40,8,1,186,32,32.0,32
broken iks cuirass,1500000,2700000,4837499,2700000,8,1,-1200000,-0.44,-1200000
broken iks faulds,2222222,1000000,2659999,1000000,10,2,1222222,1.22,2444444
broken iks headpiece,2500000,600000,1637498,600000,8,1,1900000,3.17,1900000
broken iks sandals,890000,300000,882092,300000,9,2,590000,1.97,1180000
broken iks spear,1490000,800000,1892571,800000,7,1,690000,0.86,690000
broken key ring,7795,6500,7860,7616,22,431,1295,0.2,28490
broken longbow,38998,31309,39368,27371,192,86,7689,0.25,661254
broken macuahuitl,250000,250000,2799899,0,5,0,0,0.0,0
broken ring of ending,4900,3900,4036,3440,24,63,1000,0.26,24000
broken shamanic staff,8984,8227,8956,8070,2054,1330,757,0.09,1006810
broken slicer,1998,92,2975,78,2,32,1906,20.72,3812
broken throwing axe,-1,-1,-1,-1,-1,-1,0,0,0
broken visor,633,633,0,1146,0,16,0,0.0,0
broken wedding ring,-1,0,0,0,0,0,-1,0,0
broken wooden shield,-1,0,0,0,0,0,-1,0,0
bronze amulet,348,2,92,8,172,138,346,173.0,47748
bronze gear wheel,42,0,93,0,30,0,42,0,0
bronze necklace,16400000,16400000,0,0,0,0,0,0.0,0
bronze prison key,449998,154702,241234,190979,16,13,295296,1.91,3838848
brooch of embracement,75000,5301,250000,0,1,0,69699,13.15,0
broom,394,0,322,0,7,0,394,0,0
brown bread,-1,1,41,1,10,14,-2,-2.0,-20
brown crystal splinter,425,393,439,379,3,955,32,0.08,96
brown flask,92,0,111,0,2,0,92,0,0
brown mushroom,11,10,11,10,7101,379,1,0.1,379
brown piece of cloth,788,135,592,167,158,338,653,4.84,103174
brown pit demon,13800,2700,15651,2710,3,4,11100,4.11,33300
brush,209000,209000,0,235900,0,2,0,0.0,0
brutetamer's staff,9000,300,7378,728,4,7,8700,29.0,34800
brutus bloodbeard's hat,794999,612000,861120,648240,9,6,182999,0.3,1097994
bucket,845,1,845,1,99,9,844,844.0,7596
bucket of bog water,-1,-1,-1,-1,-1,-1,0,0,0
buckle,-1,-1,-1,-1,-1,-1,0,0,0
bug meat,98,1,426,97,167,43,97,97.0,4171
buggy backpack,9999,5500,24864,12376,91,82,4499,0.82,368918
building plans for a ship,10000,10000,0,0,0,0,0,0.0,0
bulb of garlic,41,0,44,0,145,0,41,0,0
bullseye potion,539,492,510,482,1490,2728,47,0.1,70030
bunch of reed,9399,0,9444,0,3,0,9399,0,0
bunch of ripe rice,-1,21,78,68,8,162,-22,-1.05,-176
bunch of sugar cane,0,0,0,0,0,0,0,0,0
bunch of troll hair,90,1,71,7,2,56,89,89.0,178
bunch of wheat,88,1,144,1,14,22,87,87.0,1218
bundle of cursed straw,-1,-1,-1,-1,-1,-1,0,0,0
bundle of rags,-1,0,0,0,0,0,-1,0,0
bunnyslippers,86100111,116000000,149962962,131040277,3,8,-29899889,-0.26,-89699667
burnt down rainbow torch,-1,-1,-1,-1,-1,-1,0,0,0
burnt out devourer core,30001,30001,0,0,0,0,0,0.0,0
burnt scroll,1,0,1,0,1,0,1,0,0
burst arrow,10,1,11,7,591,634,9,9.0,5319
butcher's axe,17930,17280,16985,16869,24,552,650,0.04,15600
butterfly ring,1892,1768,1965,1638,552,423,124,0.07,52452
cake backpack,2600,410,4811,1236,119,108,2190,5.34,236520
cake cabinet kit,0,2,0,12,0,2,-2,-1.0,0
cake tapestry,1995,1,2342,114,16,5,1994,1994.0,9970
calibrated indicator gauge,-1,0,8000,0,1,0,-1,0,0
calopteryx cape,15199,11553,15010,11292,102,115,3646,0.32,371892
camouflage backpack,132,22,475,19,186,285,110,5.0,20460
camouflage bag,800,1,6743,625,5,8,799,799.0,3995
candelabrum,3000,0,3322,0,1,0,3000,0,0
candle made of human tallow,5555,5555,99999,0,2,0,0,0.0,0
candle stump,48898,1223,53179,25084,17,11,47675,38.98,524425
candy,14,1,60,3,55,272,13,13.0,715
candy cane,150,59,176,27,89,393,91,1.54,8099
candy floss,8999,2,12165,3,12,5,8997,4498.5,44985
candy floss (large),-1,-1,-1,-1,-1,-1,0,0,0
canopy bed kit,-1,-1,-1,-1,-1,-1,0,0,0
cape,498,229,447,183,102,389,269,1.17,27438
capricious heart,700,1651,0,1651,0,2,-951,-0.58,0
capricious robe,400,400,0,0,0,0,0,0.0,0
captured wolf,480,1,482,1,7,3,479,479.0,1437
carapace shield,29123,26320,30982,24549,32,36,2803,0.11,89696
carlin sword,149,21,620,25,15,57,128,6.1,1920
carniphila seeds,150,38,150,36,1,95,112,2.95,112
carnisylvan bark,15,499,26,55,426,135,-484,-0.97,-65340
carnisylvan finger,301,999,23,120,797,300,-698,-0.7,-209400
carnivostrich feather,-1,105,0,306,0,12,-106,-1.01,0
carrion worm fang,42,15,35,16,14,152,27,1.8,378
carrot,199,1,143,1,134,28,198,198.0,5544
carrot cake,78356,58600,84011,56104,121,43,19756,0.34,849508
carrot on a stick,14100,14100,17939,9453,138,69,0,0.0,0
carrying device,0,0,0,0,0,0,0,0,0
case of rust bugs,10000,10000,0,0,0,0,0,0.0,0
cask of brown ale (item),-1,-1,-1,-1,-1,-1,0,0,0
castle shield,5890,2705,4578,2590,16,30,3185,1.18,50960
cat's paw,1999,1523,2024,1519,4,203,476,0.31,1904
cauliflower,-1,2,0,2,0,1,-3,-1.5,0
cave chimera head,404,901,0,901,0,2,-497,-0.55,0
cave chimera leg,223,551,0,551,0,1,-328,-0.6,0
cave devourer eyes,183,183,0,358,0,4,0,0.0,0
cave devourer legs,-1,82,0,217,0,5,-83,-1.01,0
cave devourer maw,-1,82,0,431,0,6,-83,-1.01,0
cave turnip,-1,0,0,0,0,0,-1,0,0
cavebear skull,10000,10000,0,1700,0,1,0,0.0,0
centipede leg,90,12,100,10,2,131,78,6.5,156
ceremonial ankh,20985,16337,27069,16935,38,80,4648,0.28,176624
ceremonial mask,-1,0,0,0,0,0,-1,0,0
certificate,1950,0,2499,0,3,0,1950,0,0
chain armor,80,22,87,26,15,141,58,2.64,870
chain bolter,5100000,5100000,0,0,0,0,0,0.0,0
chain helmet,-1,1,0,2,0,13,-2,-2.0,0
chain legs,-1,1,0,5,0,15,-2,-2.0,0
chameleon rune,42,5,47,14,392,91,37,7.4,3367
chaos mace,9449,8870,9466,8638,3,722,579,0.07,1737
chargeable compass,1936,1000,2617,911,7,33,936,0.94,6552
charged alicorn ring,133999,125022000,141977222,135807700,18,10,-124888001,-1.0,-1248880010
charged arboreal ring,98200000,98200000,128249722,118798818,18,11,0,0.0,0
charged arcanomancer sigil,95002000,95002000,109002777,99289714,18,7,0,0.0,0
charged ghost charm,54999,5555,55000,4499,8,2,49444,8.9,98888
charged spiritthorn ring,160999,151000000,171136789,162351583,19,12,-150839001,-1.0,-1810068012
charm upgrade,1220792,850007,1062462,774056,53,21,370785,0.44,7786485
charmer's tiara,900,383,797,351,3,143,517,1.35,1551
chasm spawn abdomen,108,108,0,119,0,7,0,0.0,0
chasm spawn head,285,285,0,508,0,7,0,0.0,0
chasm spawn tail,83,83,0,70,0,9,0,0.0,0
chayenne's magical key,87000000,91000000,101666666,94666666,2,3,-4000000,-0.04,-8000000
cheese,10,2,14,2,52,20,8,4.0,160
cheese cookie,-1,0,0,0,0,0,-1,0,0
cheese cutter,45,45,46,43,10,222,0,0.0,0
cheesy figurine,300,76,219,108,64,253,224,2.95,14336
cheesy membership card,98000,98000,129000,105200,2,11,0,0.0,0
cherry,-1,0,51,0,15,0,-1,0,0
chicken feather,4088,2029,2915,2141,304,620,2059,1.01,625936
chimney kit,100000,100000,0,0,0,0,0,0.0,0
chisel,43,0,43,0,2,0,43,0,0
chitinous mouth (baron from below),-1,-1,-1,-1,-1,-1,0,0,0
chitinous mouth (count of the core),-1,-1,-1,-1,-1,-1,0,0,0
chocolate cake,4499,400,4290,412,25,6,4099,10.25,24594
chocolatey dragon scale legs,300,11,3480,10,8,31,289,26.27,2312
chopper of carving,-1,-1,-1,-1,-1,-1,0,0,0
chopper of destruction,1780000,1002029,1682631,1200542,20,14,777971,0.78,10891594
chopper of mayhem,-1,-1,-1,-1,-1,-1,0,0,0
chopper of remedy,-1,-1,-1,-1,-1,-1,0,0,0
christmas card,38,1,46,1,44,121,37,37.0,1628
christmas cookie tray,1400,100,2422,400,15,3,1300,13.0,3900
christmas present bag,352,152,725,250,72,272,200,1.32,14400
christmas token,379,270,463,234,181,156,109,0.4,17004
cigar,19999,500,26648,500,6,1,19499,39.0,19499
claw of 'the noxious spawn',60000,30010,49619,12879,68,40,29990,1.0,1199600
clay lump,1700,130,1297,538,41,143,1570,12.08,64370
cleaver,49,0,49,0,1,0,49,0,0
clerical mace,80,61,146,54,36,101,19,0.31,684
cliff strider claw,268,270,0,614,0,10,-2,-0.01,0
closed trap,199,0,772,0,12,0,199,0,0
club,3780,0,3799,0,1,0,3780,0,0
club of the fury,0,1000,0,5500,0,2,-1000,-1.0,0
club ring,648,505,706,482,428,458,143,0.28,61204
cluster of solace,6492,5005,7024,6263,343,1076,1487,0.3,510041
coal,18,1,33,6,50,309,17,17.0,850
coal basin kit,100000,100000,0,0,0,0,0,0.0,0
coal eyes,240,5000,0,5080,0,5,-4760,-0.95,0
coat,10,0,100,0,1,0,10,0,0
cobra axe,2997000,1711111,2526694,2215171,61,40,1285889,0.75,51435560
cobra boots,22394000,21000000,21541626,18696833,14,6,1394000,0.07,8364000
cobra club,2774000,2002002,2907975,2387477,28,21,771998,0.39,16211958
cobra crest,950,558,677,553,5,382,392,0.7,1960
cobra crossbow,2584999,2014001,2494572,2145719,88,73,570998,0.28,41682854
cobra crown,49576,49380,51078,49000,101,208,196,0.0,19796
cobra hood,7299975,6012000,6810597,6100053,60,53,1287975,0.21,68262675
cobra rod,6434999,6100000,7038464,6216628,58,56,334999,0.05,18759944
cobra sword,1999990,1712000,2417862,2063622,58,47,287990,0.17,13535530
cobra tongue,775,231,1757,346,193,111,544,2.35,60384
cobra wand,2194000,2003000,2459735,1994989,53,35,191000,0.1,6685000
cocktail glass,11,11,0,0,0,0,0,0.0,0
coconut,577,10,981,115,38,65,567,56.7,21546
coconut shoes,6666,181,6666,453,1,8,6485,35.83,6485
coconut shrimp bake,7775,1701,8394,2403,51,26,6074,3.57,157924
collar of blue plasma,7195,6308,7599,6704,1801,1233,887,0.14,1093671
collar of green plasma,6100,5746,6930,5984,1559,1330,354,0.06,470820
collar of red plasma,18648,17036,20733,18449,3238,1700,1612,0.09,2740400
coloured egg (blue),-1,-1,-1,-1,-1,-1,0,0,0
coloured egg (green),-1,-1,-1,-1,-1,-1,0,0,0
coloured egg (purple),-1,-1,-1,-1,-1,-1,0,0,0
coloured egg (red),-1,-1,-1,-1,-1,-1,0,0,0
coloured egg (yellow),-1,-1,-1,-1,-1,-1,0,0,0
colourful feather,65,65,0,61,0,37,0,0.0,0
colourful feathers,97000,40000,104103,57216,12,7,57000,1.43,399000
colourful fireworks rocket,-1,-1,-1,-1,-1,-1,0,0,0
colourful snail shell,-1,-1,-1,-1,-1,-1,0,0,0
comb,998,0,998,0,1,0,998,0,0
combat knife,49,0,72,0,11,0,49,0,0
compass,1936,1000,2617,911,7,33,936,0.94,6552
composite hornbow,25598,24730,25552,24699,112,278,868,0.04,97216
compound eye,0,108,0,112,0,111,-108,-1.0,0
compromising letter,-1,50,0,50,0,1,-51,-1.02,0
condensed energy,86,171,0,175,0,6,-85,-0.5,0
contract,-1,10000,0,38333,0,2,-10001,-1.0,0
control unit,700,51,810,52,46,44,649,12.73,28556
convince creature rune,197,21,400,12,71,89,176,8.38,12496
cookbook,75000,0,16277,0,9,0,75000,0,0
cookie,-1,0,0,0,0,0,-1,0,0
copper prison key,350000,154564,272250,0,4,0,195436,1.26,0
copper shield,13,13,0,11,0,5,0,0.0,0
copper valve,5000,0,3026,0,23,0,5000,0,0
coral brooch,798,705,798,709,1,405,93,0.13,93
coral comb,799000,701000,1061148,707404,6,6,98000,0.14,588000
corncob,-1,1,18,1,3,26,-2,-2.0,-6
corned fish,70000,5555,70000,1852,1,3,64445,11.6,64445
cornucopia,1390000,355500,1370000,0,2,0,1034500,2.91,0
corrupted flag,-1,-1,-1,-1,-1,-1,0,0,0
costume bag (common),-1,-1,-1,-1,-1,-1,0,0,0
costume bag (deluxe),-1,-1,-1,-1,-1,-1,0,0,0
costume bag (retro),-1,-1,-1,-1,-1,-1,0,0,0
costume bag (uncommon),-1,-1,-1,-1,-1,-1,0,0,0
countess sorrow's frozen tear,88000,88000,378950,22000,2,1,0,0.0,0
cow bell,40,40,0,0,0,0,0,0.0,0
cowbell,195,129,190,123,17,186,66,0.51,1122
cowtana,2799,2264,2424,1963,70,441,535,0.24,37450
crab man claws,255,255,0,392,0,29,0,0.0,0
crab pincers,125,10,555,10,25,127,115,11.5,2875
cracked alabaster vase,64,64,0,87,0,44,0,0.0,0
crackling egg,120000,120000,0,0,0,0,0,0.0,0
cranial basher,49900,16502,33724,18351,4,4,33398,2.02,133592
crawler head plating,5248,3711,5070,3913,422,311,1537,0.41,478007
crawler's essence,9000,5000,11067,3801,14,14,4000,0.8,56000
cream cake,5795,4001,8100,4200,10,108,1794,0.45,17940
crest of the deep seas,69899,55432,75389,48551,191,163,14467,0.26,2358121
crimson rose,98,2,105,2,51,11,96,48.0,1056
crimson sword,800,1,655,99,95,87,799,799.0,69513
crimson sword (uzgod),-1,-1,-1,-1,-1,-1,0,0,0
crocodile boots,1600,450,1486,400,43,86,1150,2.56,49450
crocodile steak,10000,10000,0,0,0,0,0,0.0,0
crossbow,19,19,0,16,0,155,0,0.0,0
crossbow of carving,-1,-1,-1,-1,-1,-1,0,0,0
crossbow of destruction,549986,408717,547533,420042,29,25,141269,0.35,3531725
crossbow of mayhem,-1,-1,-1,-1,-1,-1,0,0,0
crossbow of remedy,-1,-1,-1,-1,-1,-1,0,0,0
crowbar,7,1,139,4,218,144,6,6.0,864
crown,45999000,40000000,44983823,43109454,17,11,5999000,0.15,65989000
crown (plant),-1,-1,-1,-1,-1,-1,0,0,0
crown armor,12100,11181,11882,11210,142,1945,919,0.08,130498
crown backpack,3333,830,3484,429,107,62,2503,3.02,155186
crown helmet,2500,2118,2472,2111,288,1838,382,0.18,110016
crown legs,11999,11200,12047,11205,171,959,799,0.07,136629
crown shield,7944,7380,8051,7454,104,1015,564,0.08,58656
crude umbral axe,98000,29162,49020,28447,7,4,68838,2.36,275352
crude umbral blade,54974,21995,72675,20197,6,8,32979,1.5,197874
crude umbral bow,89727,34695,42609,19064,23,16,55032,1.59,880512
crude umbral chopper,59900,20000,94794,14825,2,3,39900,2.0,79800
crude umbral crossbow,77499,53000,79655,49801,5,7,24499,0.46,122495
crude umbral hammer,17000,5402,16570,7623,5,5,11598,2.15,57990
crude umbral mace,64300,11900,80738,16494,5,7,52400,4.4,262000
crude umbral slayer,34889,4900,62298,7603,3,6,29989,6.12,89967
crude umbral spellbook,207900,146004,215137,136669,15,11,61896,0.42,680856
crude wood planks,249799,10000,249749,103500,2,3,239799,23.98,479598
cruelty's chest,709000,709000,0,672400,0,5,0,0.0,0
cruelty's claw,628000,628000,0,579041,0,6,0,0.0,0
crunor idol,29091,29091,0,29147,0,31,0,0.0,0
crusader helmet,6099,5480,6008,5525,101,641,619,0.11,62519
cryana,260000,84000,280830,76000,7,1,176000,2.1,176000
crystal backpack,50000,37001,116562,69166,27,16,12999,0.35,207984
crystal ball,58,58,180,58,1,30,0,0.0,0
crystal bone,105,105,0,147,0,12,0,0.0,0
crystal boots,56666508,56666508,0,55000000,0,1,0,0.0,0
crystal crossbow,35990,34380,35637,34386,23,245,1610,0.05,37030
crystal lamp,5036,5036,0,0,0,0,0,0.0,0
crystal mace,11998,11730,12427,11185,9,540,268,0.02,2412
crystal necklace,400,388,412,388,11,407,12,0.03,132
crystal of balance,9900,402,20672,2800,4,8,9498,23.63,37992
crystal of focus,6599,1015,7510,1073,5,50,5584,5.5,27920
crystal of power,2800,1773,2861,1727,12,75,1027,0.58,12324
crystal pedestal (blue),-1,-1,-1,-1,-1,-1,0,0,0
crystal pedestal (cyan),-1,-1,-1,-1,-1,-1,0,0,0
crystal pedestal (green),-1,-1,-1,-1,-1,-1,0,0,0
crystal pedestal (red),-1,-1,-1,-1,-1,-1,0,0,0
crystal ring,-1,10000,5000,10000,1,1,-10001,-1.0,-10001
crystal ring (eleonore),-1,-1,-1,-1,-1,-1,0,0,0
crystal sword,550,490,610,474,25,838,60,0.12,1500
crystal table kit,900000,10043,900000,0,1,0,889957,88.61,0
crystal wand,15000,6111,15000,6522,1,13,8889,1.45,8889
crystalline armor,16900,15680,16997,15708,7,260,1220,0.08,8540
crystalline arrow,21,19,20,18,1495,398,2,0.11,796
crystalline arrow earth,-1,-1,-1,-1,-1,-1,0,0,0
crystalline arrow energy,-1,-1,-1,-1,-1,-1,0,0,0
crystalline arrow fire,-1,-1,-1,-1,-1,-1,0,0,0
crystalline arrow ice,-1,-1,-1,-1,-1,-1,0,0,0
crystalline axe,14900,1000,25995,14381,34,22,13900,13.9,305800
crystalline spikes,-1,-1,-1,-1,-1,-1,0,0,0
crystalline sword,1000,236,946,210,89,198,764,3.24,67996
crystallized anger,1599,348,2176,678,129,217,1251,3.59,161379
cucumber,9,0,6,0,16,0,9,0,0
cultish mask,8099,7714,9947,8356,810,1039,385,0.05,311850
cultish robe,239,128,263,137,312,1045,111,0.87,34632
cultish symbol,299,298,508,402,6,281,1,0.0,6
cure poison rune (item),-1,-1,-1,-1,-1,-1,0,0,0
curious matter,499,370,463,361,14,297,129,0.35,1806
curl of hair,31000,289000,299999,289000,2,1,-258000,-0.89,-258000
cursed bone,5871,5581,5890,5396,25,331,290,0.05,7250
cursed shoulder spikes,-1,-1,-1,-1,-1,-1,0,0,0
cyan crystal fragment,-1,-1,-1,-1,-1,-1,0,0,0
cyclops toe,369,151,394,116,180,515,218,1.44,39240
cyclops trophy,-1,-1,-1,-1,-1,-1,0,0,0
dagger,20729,19880,20339,19685,51,1233,849,0.04,43299
damaged armor plates,212,212,0,207,0,67,0,0.0,0
damaged helmet,1000,4321,0,4321,0,1,-3321,-0.77,0
damaged logbook,-1,0,0,0,0,0,-1,0,0
damaged steel helmet,2299994,302000,2322497,0,4,0,1997994,6.62,0
damaged worm head,7680,7680,0,6533,0,18,0,0.0,0
damselfly eye,25,1,45,8,2,65,24,24.0,48
damselfly wing,189,38,243,61,173,163,151,3.97,24613
dandelion seeds,-1,-1,-1,-1,-1,-1,0,0,0
dangerous proto matter,-1,-1,-1,-1,-1,-1,0,0,0
daramian axe,-1,0,0,0,0,0,-1,0,0
daramian mace,500,1,895,2,15,21,499,499.0,7485
daramian waraxe,999,650,905,612,23,178,349,0.54,8027
dark armor,289,380,45,133,338,205,-91,-0.24,-18655
dark bell,278000,278000,99000,0,1,0,0,0.0,0
dark bell (silver),-1,-1,-1,-1,-1,-1,0,0,0
dark essence,900,0,1635,0,5,0,900,0,0
dark helmet,220,156,234,155,68,148,64,0.41,4352
dark lord's cape,60000000,60000000,0,60002500,0,2,0,0.0,0
dark mushroom,100,89,112,94,119,646,11,0.12,1309
dark rosary,55,1,55,7,1,93,54,54.0,54
dark shield,428,171,385,225,19,255,257,1.5,4883
dark trinity mace,-1,0,0,0,0,0,-1,0,0
dark whispers,122497,86201,143648,115838,129,112,36296,0.42,4065152
dawnfire pantaloons,12879992,10114000,14288624,11282000,24,16,2765992,0.27,44255872
dawnfire sherwani,4184992,2658000,4619937,3260171,19,11,1526992,0.57,16796912
dead frog (item),-1,-1,-1,-1,-1,-1,0,0,0
dead weight,448,407,502,389,2,101,41,0.1,82
deadeye devious' eye patch,998979,450001,626593,459287,17,9,548978,1.22,4940802
death amplification,1790000,912460,1543084,941843,21,12,877540,0.96,10530480
death gaze,6000000,6000000,0,0,0,0,0,0.0,0
death resilience,2099999,973004,1672034,1043458,16,10,1126995,1.16,11269950
death ring,1095,987,1089,987,171,1741,108,0.11,18468
deathstrike's snippet,88900,20000,81902,45455,26,13,68900,3.44,895700
decorative ribbon,2999999,824000,2949486,820900,2,1,2175999,2.64,2175999
deed of ownership,49000,500,49000,0,1,0,48500,97.0,0
deep crystal,7495,40,7459,38,6,3,7455,186.38,22365
deepling axe,39560,23620,39097,27753,10,18,15940,0.67,159400
deepling backpack,2296,835,2703,608,63,48,1461,1.75,70128
deepling breaktime snack,-1,1,150,23,1,31,-2,-2.0,-2
deepling ceremonial dagger,444400,221357,371460,266051,22,13,223043,1.01,2899559
deepling claw,-1,-1,-1,-1,-1,-1,0,0,0
deepling filet,-1,2,3,2,5,21,-3,-1.5,-15
deepling fork,3500000,2705004,3481127,2714402,15,10,794996,0.29,7949960
deepling guard belt buckle,-1,-1,-1,-1,-1,-1,0,0,0
deepling ridge,-1,-1,-1,-1,-1,-1,0,0,0
deepling scales,33,33,0,32,0,15,0,0.0,0
deepling squelcher,7199,4204,7069,16972,34,42,2995,0.71,101830
deepling staff,-1,2130,3651,2193,11,44,-2131,-1.0,-23441
deepling warts,397,136,1184,135,220,89,261,1.92,23229
deeptags,-1,-1,-1,-1,-1,-1,0,0,0
deepworm jaws,414,414,480,409,1,185,0,0.0,0
deepworm spike roots,620,552,619,557,2,157,68,0.12,136
deepworm spikes,-1,-1,-1,-1,-1,-1,0,0,0
deer trophy,3998,3045,7810,2415,127,77,953,0.31,73381
delany's golden bug trophy,111112,111112,0,0,0,0,0,0.0,0
delicate vase,98,0,240,0,1,0,98,0,0
demon armor,121999,80624,133139,96119,84,60,41375,0.51,2482500
demon backpack,995,25,539,161,318,187,970,38.8,181390
demon dust,740,452,931,512,162,180,288,0.64,46656
demon helmet,70000,50300,55780,42919,239,187,19700,0.39,3683900
demon horn,1070,834,987,811,45,492,236,0.28,10620
demon legs,3641994,2818001,3896767,2986075,25,14,823993,0.29,11535902
demon shield,30759,29930,30723,29756,421,874,829,0.03,349009
demon trophy,43900,33212,40475,36141,31,46,10688,0.32,331328
demonbone,157720,157720,559925,0,2,0,0,0.0,0
demonbone amulet,34600,30900,31971,29924,8,100,3700,0.12,29600
demonic candy ball,3963,1523,3190,1547,49,38,2440,1.6,92720
demonic essence,997,974,1001,975,263,2645,23,0.02,6049
demonic finger,335,335,0,0,0,0,0,0.0,0
demonic skeletal hand,549,205,909,179,192,396,344,1.68,66048
demonic tapestry,239677,100100,223125,87438,12,12,139577,1.39,1674924
demonrage sword,36777,35280,36796,35313,4,238,1497,0.04,5988
demonwing axe,579994,200000,569116,518025,7,9,379994,1.9,2659958
depth calcei,384200,350000,383211,320934,109,107,34200,0.1,3659400
depth lorica,426899,381004,403946,329908,80,91,45895,0.12,3671600
depth ocrea,65000,25600,69396,29429,27,17,39400,1.54,669800
depth scutum,99900,22300,124873,26913,4,3,77600,3.48,232800
destroy field rune,16,1,16,5,551,182,15,15.0,2730
devil helmet,800,550,927,503,42,320,250,0.45,10500
devourer core,30001,30001,0,0,0,0,0,0.0,0
diabolic skull,18670,17336,18683,17287,12,33,1334,0.08,16008
diamond,15300,14480,23372,14039,4,278,820,0.06,3280
diamond arrow,102,98,101,97,2146,343,4,0.04,1372
diamond necklace,850000,850000,0,0,0,0,0,0.0,0
diamond sceptre,8989,2965,3245,2938,24,1125,6024,2.03,144576
diapason,81500,40007,80376,43820,28,8,41493,1.04,331944
didgeridoo,1999,0,1950,0,2,0,1999,0,0
dinky moss floret,14000,6,5939,6,10,2,13994,2332.33,27988
dinky moss floret garland,32888,105,31632,0,3,0,32783,312.22,0
diremaw brainpan,326,266,324,248,8,220,60,0.23,480
diremaw legs,195,195,275,184,2,153,0,0.0,0
dirty fur,-1,0,20,0,45,0,-1,0,0
dirty turban,198,52,196,64,2,115,146,2.81,292
disgusting trophy,2449000,223000,2449000,0,1,0,2226000,9.98,0
disintegrate rune,20,2,25,5,235,83,18,9.0,1494
distorted heart,1656,1656,0,1653,0,7,0,0.0,0
distorted robe,400,901,0,901,0,1,-501,-0.56,0
divine plate,55900,54090,55839,54102,6,37,1810,0.03,10860
djinn blade,145000,69610,133600,76718,8,5,75390,1.08,376950
djinn's lamp,10000,10000,0,0,0,0,0,0.0,0
document of the follower,2000,400,2415,400,40,7,1600,4.0,11200
document of the leader,24950,327,26743,286,24,5,24623,75.3,123115
document of the officer,3400,150,3663,150,33,6,3250,21.67,19500
dog collar,500,500,0,0,0,0,0,0.0,0
doll,2111111,950300,1752427,950566,4,3,1160811,1.22,3482433
doll of durin the almighty (replica),-1,-1,-1,-1,-1,-1,0,0,0
double axe,247,141,241,132,20,185,106,0.75,2120
doublet,900,0,3513,0,7,0,900,0,0
downy feather,2929,2929,0,2512,0,7,0,0.0,0
dowser,10,5,639,8,5,52,5,1.0,25
drachaku,9671,8817,14312,8717,6,39,854,0.1,5124
dracola's eye,298999,150100,294966,0,3,0,148899,0.99,0
dragha's spellbook,2999,500,2798,500,13,3,2499,5.0,7497
dragon backpack,760,401,797,161,168,72,359,0.9,25848
dragon blood,10000,603,99991,607,1,5,9397,15.58,9397
dragon claw,492396,357300,523640,412854,35,21,135096,0.38,2837016
dragon crown,28900,4400,55500,3845,1,9,24500,5.57,24500
dragon egg shells,-1,-1,-1,-1,-1,-1,0,0,0
dragon eye (replica),-1,-1,-1,-1,-1,-1,0,0,0
dragon figurine,59999,44091,59796,42104,4,64,15908,0.36,63632
dragon ham,-1,1,21,5,172,175,-2,-2.0,-344
dragon hammer,2000,1751,1886,1672,57,837,249,0.14,14193
dragon lance,13999,8249,9465,8205,11,76,5750,0.7,63250
dragon lord trophy,9999,7348,9887,7918,24,121,2651,0.36,63624
dragon necklace,249,50,246,51,261,507,199,3.98,51939
dragon priest's wandtip,240,62,199,118,5,130,178,2.87,890
dragon robe,109200,62001,111716,69352,4,8,47199,0.76,188796
dragon scale boots,35000000,35000000,0,37333666,0,3,0,0.0,0
dragon scale helmet,1698095,1457119,1940134,1462541,10,8,240976,0.17,1927808
dragon scale legs,300,11,3480,10,8,31,289,26.27,2312
dragon scale mail,40799,39382,42080,39408,122,199,1417,0.04,172874
dragon shield,3815,3815,4033,3672,180,605,0,0.0,0
dragon slayer,17058,14381,18737,14380,20,166,2677,0.19,53540
dragon statue kit,24999,220,29614,0,6,0,24779,112.63,0
dragon tapestry,999,10,1024,77,27,8,989,98.9,7912
dragon throne kit,129900,80400,106095,80543,10,4,49500,0.62,198000
dragon tongue,-1,1,0,275,0,7,-2,-2.0,0
dragon's tail,95,1,114,80,44,1065,94,94.0,4136
dragonbone staff,2989,2960,2996,2962,6,633,29,0.01,174
dragonfetish,73125,2125,49312,2000,2,1,71000,33.41,71000
dragonfruit,400,0,549,0,2,0,400,0,0
draken boots,41900,39280,40740,38724,80,111,2620,0.07,209600
draken sulphur,779,487,1219,598,472,208,292,0.6,60736
draken trophy,14950,7002,14950,7734,1,11,7948,1.14,7948
draken wristbands,-1,-1,-1,-1,-1,-1,0,0,0
drakinata,9948,9381,9428,9250,29,464,567,0.06,16443
draptor scales,5555,5555,0,2999,0,2,0,0.0,0
drawer kit,100000,100000,0,0,0,0,0,0.0,0
dreaded cleaver,14500,13595,14741,14110,29,814,905,0.07,26245
dream blossom staff,5774,4481,5888,4515,180,229,1293,0.29,232740
dream essence egg,200,130,219,126,25,263,70,0.54,1750
dream matter,6970,2100,6895,2504,66,62,4870,2.32,301940
dream shroud,899989,714100,1077588,885636,64,57,185889,0.26,10595673
dream warden claw,3293000,2543000,3250487,2507000,5,1,750000,0.29,750000
dream warden mask,159599,100600,173541,104457,7,10,58999,0.59,412993
dresser kit,100000,100000,0,0,0,0,0,0.0,0
drill bolt,14,10,13,7,196,186,4,0.4,744
drum,100,100,0,0,0,0,0,0.0,0
dry piece of wood,143800,75200,122986,73000,8,7,68600,0.91,480200
dubious piece of cloth,5400,1000,3817,376,90,32,4400,4.4,140800
dung ball,119800,90401,162862,90529,54,26,29399,0.33,764374
dung ball (quest),-1,-1,-1,-1,-1,-1,0,0,0
dwarf disguise kit,10000,10000,0,0,0,0,0,0.0,0
dwarven armor,5590000,4162000,4503869,3749429,29,14,1428000,0.34,19992000
dwarven axe,3000,446,4488,436,32,37,2554,5.73,81728
dwarven beard,300,40,300,62,1,36,260,6.5,260
dwarven helmet,584593,450001,642543,433406,22,19,134592,0.3,2557248
dwarven legs,211999,183601,184005,152180,181,141,28398,0.15,4004118
dwarven pickaxe,8790,893,5104,1105,359,75,7897,8.84,592275
dwarven ring,2456,2185,2324,2102,3170,756,271,0.12,204876
dwarven shield,439,37,703,51,135,101,402,10.86,40602
eagle shield,-1,0,0,0,0,0,-1,0,0
earflap,30,30,94,27,5,198,0,0.0,0
earth amplification,430000,430000,706807,439305,13,8,0,0.0,0
earth arrow,-1,1,6,1,31,113,-2,-2.0,-62
earth barbaric axe replica,50,50,0,50,0,1,0,0.0,0
earth basher replica,24999,50,24999,0,1,0,24949,498.98,0
earth blacksteel replica,50,50,0,0,0,0,0,0.0,0
earth cleric mace replica,24999,50,24999,50,1,1,24949,498.98,24949
earth crystal mace replica,50,50,0,50,0,1,0,0.0,0
earth headchopper replica,50,50,0,0,0,0,0,0.0,0
earth heroic axe replica,50,50,0,0,0,0,0,0.0,0
earth knight axe replica,50,50,0,0,0,0,0,0.0,0
earth mystic blade replica,39999,50,40000,0,1,0,39949,798.98,0
earth orcish maul replica,50,50,5000,0,2,0,0,0.0,0
earth relic sword replica,50,50,0,50,0,1,0,0.0,0
earth resilience,1350000,585463,1018420,0,19,0,764537,1.31,0
earth slayer replica,50,50,0,0,0,0,0,0.0,0
earth spike sword replica,50,50,0,0,0,0,0,0.0,0
earth war axe replica,50,50,0,0,0,0,0,0.0,0
earth war hammer replica,39999,50,39999,0,1,0,39949,798.98,0
earthborn titan armor,22999000,23000000,22999000,23000000,1,1,-1000,-0.0,-1000
earthheart cuirass,1300000,706196,846918,651027,10,6,593804,0.84,3562824
earthheart hauberk,849000,466719,824244,460010,4,1,382281,0.82,382281
earthheart platemail,1000000,850002,1000000,925001,1,2,149998,0.18,149998
earthmind raiment,2600400,666704,878493,564861,34,24,1933696,2.9,46408704
earthsoul tabard,739400,400718,652297,423503,8,7,338682,0.85,2370774
easel kit,6000000,2506000,6115333,0,5,0,3494000,1.39,0
easily inflammable sulphur,20000,20000,0,0,0,0,0,0.0,0
eclesius' sandals,10000,10000,0,0,0,0,0,0.0,0
ectoplasmic shield,299900,217203,379352,266680,33,35,82697,0.38,2729001
ectoplasmic sushi,-1,-1,-1,-1,-1,-1,0,0,0
egg,199,1,219,1,5,1,198,198.0,198
egg of the many,55000,30000,85421,40287,110,25,25000,0.83,625000
elane's crossbow,494999,26000,457923,10000,13,1,468999,18.04,468999
elder bonelord tentacle,-1,-1,-1,-1,-1,-1,0,0,0
eldritch bow,20999994,10122000,21991527,13278001,4,2,10877994,1.07,21755988
eldritch breeches,14988000,14000000,13645833,10697500,6,6,988000,0.07,5928000
eldritch casket,150000,30000,153897,30000,15,1,120000,4.0,120000
eldritch claymore,79000000,61002000,73000000,0,3,0,17998000,0.3,0
eldritch cowl,19996000,12326000,21901557,12166000,8,2,7670000,0.62,15340000
eldritch crystal,54999,40800,59945,105331,14,18,14199,0.35,198786
eldritch cuirass,12499990,9000000,11780677,9250000,7,2,3499990,0.39,6999980
eldritch folio,19999000,13502000,19287332,13752002,9,2,6497000,0.48,12994000
eldritch greataxe,29478999,21002000,29742000,21002000,2,2,8476999,0.4,16953998
eldritch hood,39999999,28918191,35842771,21356333,7,3,11081808,0.38,33245424
eldritch quiver,44950000,33054000,40204446,27018728,7,2,11896000,0.36,23792000
eldritch rod,9499999,7800000,9633333,8533933,3,3,1699999,0.22,5099997
eldritch shield,99996000,64478000,86578600,68671166,5,6,35518000,0.55,177590000
eldritch tome,30000000,36200000,37670471,36200000,4,1,-6200000,-0.17,-6200000
eldritch wand,5699999,5675861,5336564,5675861,7,1,24138,0.0,24138
eldritch warmace,29400000,24000000,29692551,25000000,2,2,5400000,0.23,10800000
elemental crystal,15000,700,6449,700,24,3,14300,20.43,42900
elemental spikes,179999,156010999,144000000,156011499,1,2,-155831000,-1.0,-155831000
elethriel's elemental bow,-1,0,0,0,0,0,-1,0,0
elite draken helmet,290979,236920,349188,299725,103,94,54059,0.23,5081546
elite draken mail,220000,133500,219195,71316,35,24,86500,0.65,2076000
elven amulet,91,79,88,40,143,622,12,0.15,1716
elven astral observer,84,70,83,70,17,653,14,0.2,238
elven brooch,10000,10000,0,0,0,0,0,0.0,0
elven hoof,8926,7306,7828,6928,639,526,1620,0.22,852120
elven legs,888,100,1978,95,7,29,788,7.88,5516
elven mail,1871899,1703101,1991521,1703313,151,118,168798,0.1,19918164
elven poetry book,99999,5555,90000,0,2,0,94444,17.0,0
elven scouting glass,998,914,1255,925,675,943,84,0.09,56700
elven vase,10000,10000,0,0,0,0,0,0.0,0
elvenhair rope,38999,16501,37170,18479,64,38,22498,1.36,854924
elvish bow,2399,1945,2287,1946,233,294,454,0.23,105782
elvish talisman,5027,4014,4438,3756,2220,1791,1013,0.25,1814283
embrace of nature,29999,13100,49077,21871,112,100,16899,1.29,1689900
emerald bangle,795,787,831,780,6,1354,8,0.01,48
emerald necklace,450000,350000,447222,350000,2,1,100000,0.29,100000
emerald sword,259997,160904,199889,143057,50,40,99093,0.62,3963720
emergency kit,10000,10000,0,0,0,0,0,0.0,0
empty beer bottle,-1,0,0,0,0,0,-1,0,0
empty beer mug,125555,125555,0,0,0,0,0,0.0,0
empty flower pot,48,0,287,0,17,0,48,0,0
empty goldfish bowl,555,0,386,0,3,0,555,0,0
empty honey glass,127,740,22,112,592,183,-613,-0.83,-112179
empty jug,0,0,0,0,0,0,0,0,0
empty potion flask (large),-1,-1,-1,-1,-1,-1,0,0,0
empty potion flask (medium),-1,-1,-1,-1,-1,-1,0,0,0
empty potion flask (small),-1,-1,-1,-1,-1,-1,0,0,0
enchanted chicken wing,32998,30000,33364,30818,97,23,2998,0.1,68954
enchanted pendulet,4491000,3338005,4289271,3568374,25,24,1152995,0.35,27671880
enchanted sleep shawl,1049900,909114,1062698,904643,136,86,140786,0.15,12107596
enchanted spear,59,25,53,20,362,99,34,1.36,3366
enchanted turtle amulet,53400000,46022000,51018043,46069916,18,12,7378000,0.16,88536000
encyclopedia (replica),-1,-1,-1,-1,-1,-1,0,0,0
energetic backpack,122403,80600,121593,73505,38,31,41803,0.52,1295893
energized demonbone,0,1,0,25000,0,2,-1,-1.0,0
energized limb,229700,127925,237657,145919,35,29,101775,0.8,2951475
energy amplification,999999,420001,987555,720454,9,11,579998,1.38,5219982
energy axe replica,50,50,29999,50,2,1,0,0.0,0
energy ball,1488,180,1529,227,12,208,1308,7.27,15696
energy bar,15,6,15,7,17,602,9,1.5,153
energy basher replica,9998,50,50000,50,1,2,9948,198.96,9948
energy blacksteel replica,50,50,0,50,0,1,0,0.0,0
energy blade replica,50,200000,0,200000,0,1,-199950,-1.0,0
energy bomb rune,208,200,212,200,1118,298,8,0.04,2384
energy cleric mace replica,5000,50,11399,50,7,3,4950,99.0,14850
energy drink,17,6,16,7,21,296,11,1.83,231
energy field rune,70,2,93,8,75,38,68,34.0,2584
energy headchopper replica,2000,50,39999,50,1,1,1950,39.0,1950
energy heroic axe replica,50,50,0,50,0,1,0,0.0,0
energy knight axe replica,50,50,50000,0,1,0,0,0.0,0
energy mace replica,50,50,4999,50,1,1,0,0.0,0
energy orcish maul replica,39999,50,39999,0,1,0,39949,798.98,0
energy relic sword replica,50,50,0,0,0,0,0,0.0,0
energy resilience,850000,400000,750505,430607,16,7,450000,1.12,3150000
energy ring,76,48,182,37,1091,1024,28,0.58,28672
energy slayer replica,50,50,0,0,0,0,0,0.0,0
energy soil,10877,6615,10355,5044,126,44,4262,0.64,187528
energy spike sword replica,39999,50,45000,0,1,0,39949,798.98,0
energy vein,353,154,349,224,49,209,199,1.29,9751
energy wall rune,84,53,80,32,274,133,31,0.58,4123
energy war axe replica,0,0,0,0,0,0,0,0,0
energy war hammer replica,0,0,0,0,0,0,0,0,0
engraved wedding ring,-1,-1,-1,-1,-1,-1,0,0,0
ensouled essence,702,702,760,542,9,149,0,0.0,0
envenom rune,-1,-1,-1,-1,-1,-1,0,0,0
envenomed arrow,-1,1,5,1,76,145,-2,-2.0,-152
epaulette,32740000,27500000,32545041,25806000,9,10,5240000,0.19,47160000
epee,8400,7915,8397,7868,65,503,485,0.06,31525
essence of a bad dream,349,304,332,307,17,886,45,0.15,765
eternal flames,64300,7000,95374,15207,8,19,57300,8.19,458400
ethno coat,-1,1,0,1,0,1,-2,-2.0,0
ewer (blue),-1,-1,-1,-1,-1,-1,0,0,0
ewer (golden),-1,-1,-1,-1,-1,-1,0,0,0
ewer (green),-1,-1,-1,-1,-1,-1,0,0,0
ewer (silver),-1,-1,-1,-1,-1,-1,0,0,0
ewer with holy water,42000,140,16333,140,3,3,41860,299.0,125580
exaltation chest,696,160,758,71,31,93,536,3.35,16616
exalted core,708962,570000,742908,604698,464,77,138962,0.24,10700074
execowtioner axe,11847,6033,11471,5923,15,36,5814,0.96,87210
execowtioner mask,-1,-1,-1,-1,-1,-1,0,0,0
executioner,56998,31146,51254,34729,9,8,25852,0.83,206816
exotic amulet,5886111,3500000,7846265,5529801,7,5,2386111,0.68,11930555
exotic flowers,1221,0,1360,0,4,0,1221,0,0
exotic legs,2000000,812020,2082390,910650,8,5,1187980,1.46,5939900
expedition backpack,1000,230,1277,236,60,28,770,3.35,21560
expedition bag,18888,10000,18388,0,6,0,8888,0.89,0
exploding cookie,0,1,0,1,0,1,-1,-1.0,0
explorer brooch,500,1,6716,6,6,49,499,499.0,2994
explosion rune,21,10,28,10,115,86,11,1.1,946
explosion rune (weak),-1,-1,-1,-1,-1,-1,0,0,0
exquisite silk,6999,2,7499,2,1,1,6997,3498.5,6997
exquisite wood,9999,0,7499,0,2,0,9999,0,0
eye of a deepling,125,125,0,113,0,61,0,0.0,0
eye of a weeper,593,593,0,541,0,9,0,0.0,0
eye of corruption,134,134,0,270,0,34,0,0.0,0
eye of the chasm,20000,0,29899,0,1,0,20000,0,0
eye of the storm,80000000,115000000,0,115000000,0,1,-35000000,-0.3,0
eye patch,998979,450001,626593,459287,17,9,548978,1.22,4940802
eye pod,99900,4000,40570,8300,5,4,95900,23.98,383600
eye-embroidered veil,887985,333333,905995,532540,5,7,554652,1.66,2773260
eyeless devourer legs,232,232,0,337,0,7,0,0.0,0
eyeless devourer maw,154,154,0,210,0,20,0,0.0,0
eyeless devourer tongue,300,300,0,300,0,3,0,0.0,0
fabulous legs,2878900,2522000,3251033,2861047,190,191,356900,0.14,67811000
fafnar symbol,998,603,999,566,2,101,395,0.66,790
fairy wings,227,192,496,199,1129,477,35,0.18,16695
fake dwarven beard,-1,10000,0,10000,0,1,-10001,-1.0,0
fake rabbit's foot,9999,10000,9999,10000,1,1,-1,-0.0,-1
faked label,-1,0,0,0,0,0,-1,0,0
falcon battleaxe,3299000,3100000,3500435,2835165,32,35,199000,0.06,6368000
falcon bow,12900000,10001000,13924429,12408718,51,38,2899000,0.29,110162000
falcon circlet,5848000,5222000,6216118,5568770,86,66,626000,0.12,41316000
falcon coif,28998000,27101000,30298390,28129050,47,44,1897000,0.07,83468000
falcon crest,5000,501,22898,586,2,63,4499,8.98,8998
falcon escutcheon,12500000,11506000,13273591,12039325,43,40,994000,0.09,39760000
falcon greaves,88995995,86006000,94595060,91039386,49,44,2989995,0.03,131559780
falcon longsword,3111000,2603000,3408227,2884177,39,35,508000,0.2,17780000
falcon mace,2938000,2204004,2873110,2474211,55,39,733996,0.33,28625844
falcon plate,37989000,34000000,38692886,35251597,47,42,3989000,0.12,167538000
falcon rod,4174000,2806000,3495555,2743408,43,30,1368000,0.49,41040000
falcon shield,3000000,3000000,13250000,0,2,0,0,0.0,0
falcon wand,2290000,1903000,3274107,2366912,55,42,387000,0.2,16254000
family brooch (dwarven),-1,-1,-1,-1,-1,-1,0,0,0
fan club membership card,-1,0,0,0,0,0,-1,0,0
fan doll of king tibianus,3500,2,2082,150,4,7,3498,1749.0,13992
fanfare,3750,1,2791,1,6,2,3749,3749.0,7498
farmer's avenger,0,0,0,0,0,0,0,0,0
feather headdress,998,6,899,6,4,11,992,165.33,3968
feedbag,6500000,2902000,4966166,3169334,6,6,3598000,1.24,21588000
fern,15,10,50,7,3,41,5,0.5,15
ferumbras puppet,197900,111100,266503,122569,14,9,86800,0.78,781200
ferumbras' amulet,20000,12100,25198,10321,41,47,7900,0.65,323900
ferumbras' candy hat,1750,600,10245,598,24,44,1150,1.92,27600
ferumbras' hat,1199999,1000102000,1106124249,1055606555,8,2,-998902001,-1.0,-1997804002
ferumbras' mana keg,49900,35002,91836,39045,10,29,14898,0.43,148980
ferumbras' staff (blunt),-1,-1,-1,-1,-1,-1,0,0,0
ferumbras' teddy,74500,10200,53452,5721,16,10,64300,6.3,643000
ferumbras' teddy santa,209500,60400,152010,37200,11,3,149100,2.47,447300
festive backpack,8552,3401,22338,8156,68,108,5151,1.51,350268
feverbloom boots,3938995,3511082,4875499,3838880,16,16,427913,0.12,6846608
fiery barbarian axe replica,50,50,0,0,0,0,0,0.0,0
fiery basher replica,50,50,0,0,0,0,0,0.0,0
fiery clerical mace replica,39999,50,39999,0,1,0,39949,798.98,0
fiery crystal mace replica,50,50,0,0,0,0,0,0.0,0
fiery dragon slayer replica,50,50,0,50,0,1,0,0.0,0
fiery headchopper replica,50,50,0,0,0,0,0,0.0,0
fiery heart,488,273,541,229,72,175,215,0.79,15480
fiery heroic axe replica,50,50,0,0,0,0,0,0.0,0
fiery horseshoe,420000,250000000,0,250000000,0,1,-249580000,-1.0,0
fiery knight axe replica,50,50,0,0,0,0,0,0.0,0
fiery mystic blade replica,50,50,0,0,0,0,0,0.0,0
fiery orcish maul replica,39999,50,39999,0,1,0,39949,798.98,0
fiery rainbow shield,-1,-1,-1,-1,-1,-1,0,0,0
fiery relic sword replica,39999,50,45000,0,2,0,39949,798.98,0
fiery spike sword replica,4999,50,4999,50,1,1,4949,98.98,4949
fiery war axe replica,50,50,0,0,0,0,0,0.0,0
fiery war hammer replica,39999,50,39999,0,1,0,39949,798.98,0
fig leaf,-1,102,184,146,13,373,-103,-1.01,-1339
figurine of cruelty,4500000,3200000,4500000,3200000,1,1,1300000,0.41,1300000
figurine of greed,3200000,1200000,3200000,0,1,0,2000000,1.67,0
figurine of hatred,1200000,2800000,0,2800000,0,1,-1600000,-0.57,0
figurine of malice,2900000,2900000,0,0,0,0,0,0.0,0
figurine of megalomania,2000000,4200000,0,4650000,0,2,-2200000,-0.52,0
figurine of spite,1200000,1200000,0,2600000,0,3,0,0.0,0
file ah-x17l89,-1,10000,0,10000,0,1,-10001,-1.0,0
filled carrying device,-1,0,0,0,0,0,-1,0,0
filled jalapeno peppers,64999,26200,59686,26795,144,39,38799,1.48,1513161
filled milk churn,10,10,0,0,0,0,0,0.0,0
filthy bunnyslippers,399,1,820,3,19,7,398,398.0,2786
final judgement,5399998,4216014,6122840,4741276,12,11,1183984,0.28,13023824
fine sulphur,40000,27,44666,27,3,1,39973,1480.48,39973
fir cone,50,12,54,8,15,93,38,3.17,570
fire amplification,1900000,806000,1652681,1058520,16,9,1094000,1.36,9846000
fire axe,7799,7391,7747,7414,128,1663,408,0.06,52224
fire blacksteel replica,50,50,0,0,0,0,0,0.0,0
fire bomb rune,150,121,149,116,1432,391,29,0.24,11339
fire bug,450,44,466,32,232,66,406,9.23,26796
fire field rune,40,2,54,4,162,64,38,19.0,2432
fire mushroom,210,192,218,185,153,613,18,0.09,2754
fire resilience,898999,411565,594851,296607,24,7,487434,1.18,3412038
fire sword,3750,3501,3941,3589,199,2137,249,0.07,49551
fire wall rune,74,41,73,34,417,131,33,0.8,4323
fireball rune,32,20,32,13,132,86,12,0.6,1032
fireball rune (weak),-1,-1,-1,-1,-1,-1,0,0,0
fireborn giant armor,158119,130315,227351,139289,12,18,27804,0.21,333648
fireheart cuirass,900000,494370,1085890,788669,13,12,405630,0.82,4867560
fireheart hauberk,943896,435457,1299000,799228,1,9,508439,1.17,508439
fireheart platemail,1190000,1000000,1190000,1000000,1,1,190000,0.19,190000
firemind raiment,994897,666668,895627,726712,100,76,328229,0.49,24945404
fireproof horn,14890,10000,25706,10010,7,24,4890,0.49,34230
firesoul tabard,320000,204472,443535,328048,20,19,115528,0.57,2195032
fireworks capsule,200,1,834,154,80,117,199,199.0,15920
fireworks in shape of '0',-1,-1,-1,-1,-1,-1,0,0,0
fireworks in shape of '1',-1,-1,-1,-1,-1,-1,0,0,0
fireworks in shape of '2',-1,-1,-1,-1,-1,-1,0,0,0
fireworks in shape of '3',-1,-1,-1,-1,-1,-1,0,0,0
fireworks in shape of '4',-1,-1,-1,-1,-1,-1,0,0,0
fireworks in shape of '5',-1,-1,-1,-1,-1,-1,0,0,0
fireworks in shape of '6',-1,-1,-1,-1,-1,-1,0,0,0
fireworks in shape of '7',-1,-1,-1,-1,-1,-1,0,0,0
fireworks in shape of '8',-1,-1,-1,-1,-1,-1,0,0,0
fireworks in shape of '9',-1,-1,-1,-1,-1,-1,0,0,0
fireworks rocket,125000,5006,82086,8750,16,4,119994,23.97,479976
firlefanz,139800,57100,152922,66400,15,12,82700,1.45,992400
fish,500,1,572,1,5,8,499,499.0,2495
fish fin,183,131,157,122,172,666,52,0.4,8944
fish flakes,-1,10000,0,10000,0,1,-10001,-1.0,0
fish tail,-1,0,1,0,5,0,-1,0,0
fishing rod,500,1,572,1,5,8,499,499.0,2495
fishnapped goldfish,15000,7000,17085,2935,5,3,8000,1.14,24000
fist on a stick,395996,222509,354427,217267,41,12,173487,0.78,2081844
flames of the percht queen,73800,38015,85509,43204,48,45,35785,0.94,1610325
flaming arrow,-1,1,5,1,103,104,-2,-2.0,-206
flash arrow,-1,1,2,1,62,217,-2,-2.0,-124
flask of chitin dissolver,298,0,172,0,3,0,298,0,0
flask of cough syrup,2999,0,3135,0,39,0,2999,0,0
flask of crown polisher,1385,65,1368,46,107,11,1320,20.31,14520
flask of demonic blood,48,46,54,42,94,1064,2,0.04,188
flask of dissolved chitin,2169,50,1855,50,3,2,2119,42.38,4238
flask of embalming fluid,3558,3274,3814,3246,1107,1598,284,0.09,314388
flask of extra greasy oil,2000,0,33863,0,4,0,2000,0,0
flask of plant poison,7998,0,9633,0,3,0,7998,0,0
flask of poison,-1,0,0,0,0,0,-1,0,0
flask of rust remover,82,29,82,26,1209,111,53,1.83,5883
flask of warrior's sweat,10300,9533,10356,9463,122,242,767,0.08,93574
flask with beaver bait,-1,1,68,1,6,15,-2,-2.0,-12
flask with magical oil,-1,0,0,0,0,0,-1,0,0
flask with oil and blood,-1,0,0,0,0,0,-1,0,0
flask with paint,0,0,0,0,0,0,0,0,0
flawless ice crystal,20,20,0,0,0,0,0,0.0,0
flexible dragon scale,99,99,0,20,0,2,0,0.0,0
flintstone,403,403,0,405,0,19,0,0.0,0
flour,347,1,637,17,145,38,346,346.0,13148
flower bouquet,99,2,212,2,18,18,97,48.5,1746
flower bowl,888,1,270,1,99,53,887,887.0,47011
flower dress,606,606,23499,533,2,16,0,0.0,0
flower wreath,-1,-1,-1,-1,-1,-1,0,0,0
fly agaric (item),-1,-1,-1,-1,-1,-1,0,0,0
focus cape,5998,5870,5953,5562,570,2754,128,0.02,72960
folded artefact carpet i,1100,1100,26294,0,8,0,0,0.0,0
folded artefact carpet ii,1100,1100,15599,0,5,0,0,0.0,0
folded artefact carpet iii,-1,1000,14285,1000,7,1,-1001,-1.0,-1001
folded artefact carpet iv,9998,1100,15221,550,18,2,8898,8.09,17796
folded artefact carpet v,1100,1100,14999,0,4,0,0,0.0,0
folded artefact carpet vi,9999,1100,16999,0,10,0,8899,8.09,0
folded artefact carpet vii,10001,10001,0,0,0,0,0,0.0,0
folded eldritch carpet,1397541,600000,1500000,683333,1,3,797541,1.33,797541
folded rift carpet,2465,1032,2470,1468,201,243,1433,1.39,288033
folded void carpet,1398,624,1983,861,142,202,774,1.24,109908
food crate,20000,20000,0,0,0,0,0,0.0,0
food matrix crystal,50000,0,50000,0,1,0,50000,0,0
forbidden fruit,4999000,2227000,3845500,2106000,6,1,2772000,1.24,2772000
forbidden tome,5000000,10000000,0,12259462,0,6,-5000000,-0.5,0
fork,3500000,2705004,3481127,2714402,15,10,794996,0.29,7949960
formula for a memory potion,0,0,0,0,0,0,0,0,0
four-leaf clover,6297998,5000030,6261856,5277380,7,8,1297968,0.26,9085776
fox paw,91,66,93,67,8,531,25,0.38,200
foxtail,6090000,4591000,5638000,0,5,0,1499000,0.33,0
foxtail amulet,184994,161000,155742,131943,273,218,23994,0.15,5230692
framed birthday card,46993,10000,48494,9050,2,10,36993,3.7,73986
frazzle skin,400,331,409,368,49,897,69,0.21,3381
frazzle tongue,680,635,685,627,23,968,45,0.07,1035
frazzlemaw santa,130000,31200,89204,25069,10,1,98800,3.17,98800
fresh fruit,199,1,334,1,10,25,198,198.0,1980
friendship amulet (replica),-1,-1,-1,-1,-1,-1,0,0,0
frost charm,100,0,83,0,3,0,100,0,0
frost giant pelt,87,87,0,81,0,19,0,0.0,0
frostbite herb,0,0,0,0,0,0,0,0,0
frostflower boots,12090000,8562000,12577395,11195103,10,10,3528000,0.41,35280000
frostheart cuirass,1200700,853000,1200700,853000,1,1,347700,0.41,347700
frostheart hauberk,1600000,689300,1300000,689300,2,1,910700,1.32,910700
frostheart platemail,700400,1000000,2144210,1000000,1,1,-299600,-0.3,-299600
frostmind raiment,2199999,1212100,1572648,1278249,41,35,987899,0.82,34576465
frostsoul tabard,677982,460000,571424,501667,5,3,217982,0.47,653946
frosty ear of a troll,30,1,300,8,2,29,29,29.0,58
frosty heart,336,224,335,182,126,392,112,0.5,14112
frozen chain,25500,25000,27500,25000,2,1,500,0.02,500
frozen claw,14999,1000,17666,276,2,4,13999,14.0,27998
frozen heart (replica),-1,-1,-1,-1,-1,-1,0,0,0
frozen lightning,590,220,548,228,5,246,370,1.68,1850
frozen plate,54000,3800,16546,4204,21,9,50200,13.21,451800
frozen starlight,26999,16201,29081,17106,150,127,10798,0.67,1371346
frozen time,480,2250,0,2250,0,4,-1770,-0.79,0
funeral urn,-1,0,0,0,0,0,-1,0,0
fur armor,4944,4659,4956,4564,47,996,285,0.06,13395
fur backpack,91,22,127,12,153,188,69,3.14,10557
fur bag,488,0,932,0,25,0,488,0,0
fur boots,4800,1100,2005,950,23,48,3700,3.36,85100
fur cap,499999,35457,699999,0,4,0,464542,13.1,0
fur shred,-1,-1,-1,-1,-1,-1,0,0,0
furious frock,59880000,50000000,59880000,50000000,1,1,9880000,0.2,9880000
furry club,1000,915,1022,852,52,1126,85,0.09,4420
galea mortis,1499000,1046100,2058220,1412450,54,49,452900,0.43,22192100
garlic bread,22222,1001,27861,1321,31,14,21221,21.2,297094
garlic cookie,3333,101,2426,290,67,41,3232,32.0,132512
garlic necklace,59,59,147,85,1386,831,0,0.0,0
garnet necklace,350000,355555,0,355555,0,1,-5555,-0.02,0
gauze bandage,89,69,82,61,28,447,20,0.29,560
gear crystal,-1,-1,-1,-1,-1,-1,0,0,0
gear wheel,42,0,93,0,30,0,42,0,0
gearwheel chain,4999,4070,4987,4306,102,322,929,0.23,94758
gem holder,-1,10000,0,10000,0,1,-10001,-1.0,0
gemmed figurine,5780,3420,4966,3448,3,535,2360,0.69,7080
geomancer's robe,900,5,996,26,1,8,895,179.0,895
geomancer's staff,599,76,599,76,1,7,523,6.88,523
ghastly dragon head,-1,-1,-1,-1,-1,-1,0,0,0
ghost backpack,3500000,2704000,3328606,2804500,28,12,796000,0.29,9552000
ghost charm,54999,5555,55000,4499,8,2,49444,8.9,98888
ghost chestplate,2400890,2133002,2634412,2393213,94,108,267888,0.13,25181472
ghost claw,193333,77000,247734,133334,34,19,116333,1.51,2210327
ghost duster,-1,0,0,0,0,0,-1,0,0
ghost's tear,30000,5000,37499,5000,2,3,25000,5.0,50000
ghostly tissue,296,10,298,22,1,34,286,28.6,286
ghoul snack,250,30,269,30,36,258,220,7.33,7920
giant amethyst,60900,58800,60190,57173,11,479,2100,0.04,23100
giant ape's hair,89999,0,150000,0,1,0,89999,0,0
giant crab pincer,10000,10000,0,10000,0,1,0,0.0,0
giant emerald,90999,87800,90489,85020,15,361,3199,0.04,47985
giant eye,-1,126,1332,237,3,20,-127,-1.01,-381
giant pacifier,129,1,736,6,19,38,128,128.0,2432
giant ruby,69599,68700,72499,65944,7,368,899,0.01,6293
giant sapphire,50979,49090,50763,48143,7,688,1889,0.04,13223
giant shimmering pearl,2995,2955,2899,2898,5,920,40,0.01,200
giant shimmering pearl (brown),-1,-1,-1,-1,-1,-1,0,0,0
giant shimmering pearl (green),-1,-1,-1,-1,-1,-1,0,0,0
giant shrimp,130000,100406,188584,83419,14,5,29594,0.29,147970
giant smithhammer,490,26,1606,26,11,25,464,17.85,5104
giant sword,16680,15916,17078,15963,128,1752,764,0.05,97792
giant tentacle,9091,9091,0,7472,0,18,0,0.0,0
giant topaz,80999,78700,82704,75991,15,272,2299,0.03,34485
gilded birthday cup,10000,10000,10000,10000,1,5,0,0.0,0
gilded eldritch bow,7000000,7000000,0,0,0,0,0,0.0,0
gilded eldritch claymore,84999999,20000000,84999999,0,1,0,64999999,3.25,0
gilded eldritch greataxe,10000000,10000000,0,0,0,0,0,0.0,0
gilded eldritch rod,0,14000000,0,14000000,0,1,-14000000,-1.0,0
gilded eldritch wand,29999999,10022288,27499666,0,3,0,19977711,1.99,0
gilded eldritch warmace,-1,0,39850700,0,1,0,-1,0,0
gill coat,2672,497,4258,879,94,60,2175,4.38,130500
gill gugel,3756,101,5620,805,101,78,3655,36.19,285090
gill legs,3629,1463,5955,1848,221,139,2166,1.48,301074
gill necklace,23173,21098,23558,19768,1690,748,2075,0.1,1552100
gingerbread recipe,9000,100,9425,0,3,0,8900,89.0,0
gingerbreadman,989,251,925,261,77,234,738,2.94,56826
girl's dress,-1,0,0,0,0,0,-1,0,0
girlish hair decoration,30,21,33,17,7,304,9,0.43,63
girtablilu warrior carapace,201,201,0,385,0,9,0,0.0,0
glacial rod,6499,6382,6604,6346,140,1123,117,0.02,16380
glacier amulet,1549,1456,1556,1474,1312,1024,93,0.06,95232
glacier kilt,11200,10830,11328,10755,157,1152,370,0.03,58090
glacier mask,2999,2470,2852,2466,46,583,529,0.21,24334
glacier robe,11100,10820,11287,10852,67,803,280,0.03,18760
glacier shoes,3876,2470,4726,2466,83,499,1406,0.57,116698
gland,5555,5555,0,0,0,0,0,0.0,0
glass of goo,10000000,15000004,0,16000002,0,2,-5000004,-0.33,0
glass tube,0,0,0,0,0,0,0,0,0
gleaming starlight vial,-1,-1,-1,-1,-1,-1,0,0,0
glimmering soil,14000,515,14000,5,1,1,13485,26.18,13485
glistening bone,83,151,0,151,0,4,-68,-0.45,0
glob of acid slime,24,21,23,20,2,438,3,0.14,6
glob of glooth,118,72,105,65,14,278,46,0.64,644
glob of mercury,12,12,300,12,1,52,0,0.0,0
glob of tar,12,12,0,13,0,62,0,0.0,0
globe kit,100000,100000,0,0,0,0,0,0.0,0
gloom wolf fur,14647,12732,17192,14007,1029,720,1915,0.15,1378800
glooth amulet,1997,1753,2183,1753,111,670,244,0.14,27084
glooth axe,1894,1326,1586,1302,36,709,568,0.43,20448
glooth backpack,84,10,97,7,99,92,74,7.4,6808
glooth bag,-1,-1,-1,-1,-1,-1,0,0,0
glooth blade,2098,1321,2155,1319,77,701,777,0.59,59829
glooth cape,6685,6685,7144,6495,16,165,0,0.0,0
glooth capsule,990,175,537,138,66,101,815,4.66,53790
glooth club,1988,1327,1790,1316,51,687,661,0.5,33711
glooth injection tube,300,198,315,187,8,151,102,0.52,816
glooth sandwich,20,2,12,2,7,64,18,9.0,126
glooth spear,15,5,16,6,49,232,10,2.0,490
glooth steak,0,2,0,3,0,90,-2,-1.0,0
glooth whip,2800,1721,2391,1721,11,76,1079,0.63,11869
glorious axe,2500,1921,2754,2338,309,2421,579,0.3,178911
glow wine,2542,950,3294,631,43,13,1592,1.68,20696
glowing carrot,740,740,0,638,0,9,0,0.0,0
glowing mushroom,10000,100,13004,100,6,3,9900,99.0,29700
glowing rune,257,257,1443,273,1,59,0,0.0,0
glutton's mace,22500,0,22500,0,1,0,22500,0,0
gnome armor,39578000,39578000,44892954,40384250,22,16,0,0.0,0
gnome helmet,14197000,12009000,14100394,12916925,47,40,2188000,0.18,87520000
gnome legs,32884000,29011000,30619402,27872666,35,18,3873000,0.13,69714000
gnome shield,1064990,852211,960280,842960,132,101,212779,0.25,21490679
gnome sword,174899,130005,202632,149674,68,68,44894,0.35,3052792
gnomevil's hat,14900,2518,21792,3113,34,14,12382,4.92,173348
gnomish supply package,1800,151,1058,128,34,32,1649,10.92,52768
gnomish voucher type ca1,1299666,0,1024452,0,12,0,1299666,0,0
gnomish voucher type ca2,9000,333,16518,709,42,13,8667,26.03,112671
gnomish voucher type cb,8494,1721,7223,1710,46,2,6773,3.94,13546
gnomish voucher type ma1,998666,480114,1005188,0,9,0,518552,1.08,0
gnomish voucher type ma2,9000,366,14696,359,41,16,8634,23.59,138144
gnomish voucher type mb,8494,2000,6747,2000,48,1,6494,3.25,6494
goanna claw,203,203,0,181,0,112,0,0.0,0
goanna meat,155,155,176,133,5,172,0,0.0,0
goat grass,47,10,48,9,2,92,37,3.7,74
goblet of gloom,5001,5001,0,4000,0,3,0,0.0,0
goblin ear,2000,401,1953,425,12,20,1599,3.99,19188
goblin statue kit,-1,0,0,0,0,0,-1,0,0
god flowers,122,1,126,3,130,71,121,121.0,8591
gold ingot,5350,4966,5235,4924,70,1842,384,0.08,26880
gold nugget,900,676,2428,609,19,98,224,0.33,4256
gold ring,8299,7885,8507,7877,13,408,414,0.05,5382
gold token,31700,29618,34009,31818,3932,2729,2082,0.07,5681778
gold-brocaded cloth,799,105,1027,109,7,69,694,6.61,4858
golden amulet,10000,16,9700,20,5,11,9984,624.0,49920
golden armor,20499,19790,20485,19799,61,468,709,0.04,43249
golden axe,2999,36,5267,13,8,28,2963,82.31,23704
golden backpack,150,10,265,14,248,219,140,14.0,30660
golden bag,99,0,97,0,54,0,99,0,0
golden bell,109000,0,104999,0,2,0,109000,0,0
golden bijou,58900,550,70500,940,1,12,58350,106.09,58350
golden blessed shield,999999,999999,0,0,0,0,0,0.0,0
golden boots,4178992,3904004,4359656,3916548,12,11,274988,0.07,3024868
golden can of oil,1449996,1230100,1548696,1276781,13,10,219896,0.18,2198960
golden cheese wedge,40000,5621,135000,5584,2,36,34379,6.12,68758
golden cotton reel,120000,10000,174999,10000,2,1,110000,11.0,110000
golden crown,100000,100000,0,0,0,0,0,0.0,0
golden dustbin,8600,2333,7925,3263,4,30,6267,2.69,25068
golden fir cone,35000,25000,41546,21187,127,25,10000,0.4,250000
golden helmet,4210000,4210000,0,0,0,0,0,0.0,0
golden horned helmet,100000,100000,0,0,0,0,0,0.0,0
golden horseshoe,3000000,260000,2500000,260000,2,1,2740000,10.54,2740000
golden hyaena pendant,11990,7300,13413,1956,3,9,4690,0.64,14070
golden legs,30798,29710,30985,29712,122,307,1088,0.04,132736
golden lotus brooch,268,196,251,208,16,438,72,0.37,1152
golden magic longsword,999999,999999,0,0,0,0,0,0.0,0
golden mask,37600,37370,37585,35765,4,138,230,0.01,920
golden mug,245,134,226,117,145,701,111,0.83,16095
golden newspaper (replica),-1,-1,-1,-1,-1,-1,0,0,0
golden prison key,640000,154563,242744,90828,5,6,485437,3.14,2427185
golden raid token,-1,0,0,0,0,0,-1,0,0
golden rune emblem (animate dead),-1,-1,-1,-1,-1,-1,0,0,0
golden rune emblem (avalanche),-1,-1,-1,-1,-1,-1,0,0,0
golden rune emblem (chameleon),-1,-1,-1,-1,-1,-1,0,0,0
golden rune emblem (destroy field),-1,-1,-1,-1,-1,-1,0,0,0
golden rune emblem (disintegrate),-1,-1,-1,-1,-1,-1,0,0,0
golden rune emblem (energy bomb),-1,-1,-1,-1,-1,-1,0,0,0
golden rune emblem (energy wall),-1,-1,-1,-1,-1,-1,0,0,0
golden rune emblem (explosion),-1,-1,-1,-1,-1,-1,0,0,0
golden rune emblem (fire field),-1,-1,-1,-1,-1,-1,0,0,0
golden rune emblem (fireball),-1,-1,-1,-1,-1,-1,0,0,0
golden rune emblem (firebomb),-1,-1,-1,-1,-1,-1,0,0,0
golden rune emblem (great fireball),-1,-1,-1,-1,-1,-1,0,0,0
golden rune emblem (heavy magic missile),-1,-1,-1,-1,-1,-1,0,0,0
golden rune emblem (holy missile),-1,-1,-1,-1,-1,-1,0,0,0
golden rune emblem (icicle),-1,-1,-1,-1,-1,-1,0,0,0
golden rune emblem (light magic missile),-1,-1,-1,-1,-1,-1,0,0,0
golden rune emblem (magic wall),-1,-1,-1,-1,-1,-1,0,0,0
golden rune emblem (paralyze),-1,-1,-1,-1,-1,-1,0,0,0
golden rune emblem (poison bomb),-1,-1,-1,-1,-1,-1,0,0,0
golden rune emblem (soulfire),-1,-1,-1,-1,-1,-1,0,0,0
golden rune emblem (sudden death),-1,-1,-1,-1,-1,-1,0,0,0
golden rune emblem (thunderstorm),-1,-1,-1,-1,-1,-1,0,0,0
golden rune emblem (ultimate healing),-1,-1,-1,-1,-1,-1,0,0,0
golden rune emblem (wild growth),-1,-1,-1,-1,-1,-1,0,0,0
golden scorpion pendant,-1,0,0,0,0,0,-1,0,0
golden sickle,700,381,719,376,44,382,319,0.84,14036
golden skull,19990,7904,11456,7625,10,38,12086,1.53,120860
golden talon,10000,1400,8496,1400,7,7,8600,6.14,60200
goldfish bowl,555,0,386,0,3,0,555,0,0
golem blueprint,-1,0,19137,0,8,0,-1,0,0
golem disassembler,99,0,264,0,3,0,99,0,0
golem head,45000,5995,57125,5995,4,1,39005,6.51,39005
golem part,9000,25,7622,344,12,6,8975,359.0,53850
golem wrench,130358,40300,144266,39213,8,3,90058,2.23,270174
goo shell,2500000,700706,2997755,700706,1,1,1799294,2.57,1799294
gooey mass,54997,41776,63023,45243,333,85,13221,0.32,1123785
goosebump leather,1997,1650,3097,1705,749,214,347,0.21,74258
grainy fireworks powder,104,12,911,8,21,88,92,7.67,1932
grant of arms,99999,60900,102200,61033,21,9,39099,0.64,351891
grapes,50,0,6,0,41,0,50,0,0
grappling hook,77,77,0,84,0,223,0,0.0,0
grasshopper legs,43997,30201,56477,41120,404,317,13796,0.46,4373332
grave flower,998,8,1983,8,45,46,990,123.75,44550
great axe,867777,302600,622586,302728,3,2,565177,1.87,1130354
great fireball rune,58,56,57,56,3174,703,2,0.04,1406
great fireball rune (weak),-1,-1,-1,-1,-1,-1,0,0,0
great health potion,80,65,68,58,2036,4777,15,0.23,30540
great mana potion,146,142,145,142,5026,4578,4,0.03,18312
great shield,5189992,3500000,4888673,4536334,11,9,1689992,0.48,15209928
great spirit potion,157,145,172,159,1383,4565,12,0.08,16596
greed's arm,735000,735000,0,848333,0,6,0,0.0,0
green backpack,400,20,347,7,134,75,380,19.0,28500
green bag,788,0,720,0,30,0,788,0,0
green balloons,100,1,330,8,4,36,99,99.0,396
green bandage,320,153,269,143,15,208,167,1.09,2505
green bed kit,-1,-1,-1,-1,-1,-1,0,0,0
green crystal fragment,790,790,798,780,5,1154,0,0.0,0
green crystal shard,1482,1482,0,1479,0,1134,0,0.0,0
green crystal splinter,419,389,408,360,44,774,30,0.08,1320
green cushioned chair kit,-1,0,0,0,0,0,-1,0,0
green dragon leather,5900,4403,5653,4745,1175,1686,1497,0.34,1758975
green dragon scale,200,90,521,74,150,482,110,1.22,16500
green fireworks powder,170,13,238,25,15,72,157,12.08,2355
green fireworks rocket,-1,-1,-1,-1,-1,-1,0,0,0
green flask,-1,0,0,0,0,0,-1,0,0
green gem,4994,4970,4998,4979,9,5255,24,0.0,216
green gingerbread heart,150000,150000,0,0,0,0,0,0.0,0
green glass plate,195,101,271,105,28,136,94,0.93,2632
green light,48762,21600,69998,22748,12,13,27162,1.26,325944
green mushroom,99,95,97,89,119,1067,4,0.04,476
green perch,899,401,1161,325,100,114,498,1.24,49800
green piece of cloth,689,580,999,687,276,526,109,0.19,30084
green pillow,48,0,49,0,3,0,48,0,0
green pit demon,298998,1000,298999,0,1,0,297998,298.0,0
green powder,-1,0,0,0,0,0,-1,0,0
green tapestry,94,1,58,1,5,17,93,93.0,465
green tome,0,0,0,0,0,0,0,0,0
green tunic,19,1,34,1,5,7,18,18.0,90
greenwood coat,53400,31111,48734,38712,7,28,22289,0.72,156023
grey backpack,887,58,1841,38,137,121,829,14.29,100309
grey bag,788,25,1444,350,2,3,763,30.52,1526
grey raven kit,8495000,2100000,8495000,0,1,0,6395000,3.05,0
grey tome,200000,200000,0,0,0,0,0,0.0,0
grey-blue powder,-1,-1,-1,-1,-1,-1,0,0,0
griffin shield,4999,900,3724,652,6,8,4099,4.55,24594
griffinclaw container,700000,255102,514389,196411,15,4,444898,1.74,1779592
grimace,98000,98000,0,105333,0,6,0,0.0,0
grodrik's favourite axe,20000,20000,0,0,0,0,0,0.0,0
ground reed,49000,1000,30280,550,5,2,48000,48.0,96000
gruesome fan,10001,10001,0,6754,0,2,0,0.0,0
guardian axe,6290,6290,9197,7205,23,260,0,0.0,0
guardian boots,36999,34001,36531,30878,150,127,2998,0.09,380746
guardian halberd,11500,10730,11299,10514,6,454,770,0.07,4620
guardian shield,1888,1400,1853,1507,282,1611,488,0.35,137616
guidebook,66,66,0,0,0,0,0,0.0,0
hailstorm rod,3000,2788,2994,2783,338,3619,212,0.08,71656
hair of a banshee,-1,-1,-1,-1,-1,-1,0,0,0
halberd,140,65,242,81,4,147,75,1.15,300
half-digested piece of meat,248,25,305,18,10,101,223,8.92,2230
half-digested stones,28,17,37,15,12,327,11,0.65,132
half-eaten brain,23,23,348,23,33,57,0,0.0,0
hallowed axe,-1,-1,-1,-1,-1,-1,0,0,0
ham,21897,19680,22856,19506,8,138,2217,0.11,17736
hammer,21897,19680,22856,19506,8,138,2217,0.11,17736
hammer of carving,-1,-1,-1,-1,-1,-1,0,0,0
hammer of destruction,1678000,1001000,1913064,1379499,5,9,677000,0.68,3385000
hammer of mayhem,-1,-1,-1,-1,-1,-1,0,0,0
hammer of prophecy,139898,0,111999999,0,1,0,139898,0,0
hammer of remedy,-1,-1,-1,-1,-1,-1,0,0,0
hammer of wrath,29999,29280,43419,29007,5,173,719,0.02,3595
hand,549,205,909,179,192,396,344,1.68,66048
hand auger,397,0,375,0,12,0,397,0,0
hand axe,70,0,73,0,3,0,70,0,0
handcrafted ribbon,1000,0,1000,0,1,0,1000,0,0
hard-boiled hydra egg,2200,150,2633,150,9,6,2050,13.67,12300
hardened bone,68,48,99,46,81,398,20,0.42,1620
harness,9999,2003,3967,1222,91,50,7996,3.99,399800
harp kit,100000,100000,0,0,0,0,0,0.0,0
harpoon of a giant snail,13381,14381,0,14381,0,2,-1000,-0.07,0
harpy feathers,200,200,0,488,0,27,0,0.0,0
hat for eclesius (dark),-1,-1,-1,-1,-1,-1,0,0,0
hat for eclesius (pink),-1,-1,-1,-1,-1,-1,0,0,0
hat for eclesius (wooden),-1,-1,-1,-1,-1,-1,0,0,0
hat of the mad,68999,57707,61012,46836,220,137,11292,0.2,1547004
hatched rorc egg,28,8,28,12,2,40,20,2.5,40
hatchet,-1,5,50,5,2,9,-6,-1.2,-12
haunch of boar,189,1,181,4,84,26,188,188.0,4888
haunted blade,7950,7867,7917,7795,74,2306,83,0.01,6142
haunted mirror piece,666779,666779,2199997,0,2,0,0,0.0,0
haunted piece of wood,395,38,1750,61,2,38,357,9.39,714
havoc blade,899000,619000,1023649,731104,10,10,280000,0.45,2800000
hazardous heart,1666,4501,0,4501,0,2,-2835,-0.63,0
hazardous robe,1000,2503,0,2503,0,1,-1503,-0.6,0
head (brachiodemon),-1,-1,-1,-1,-1,-1,0,0,0
head (many faces),-1,-1,-1,-1,-1,-1,0,0,0
head of abyssador,2000,400,3399,345,3,55,1600,4.0,4800
head of deathstrike,-1,-1,-1,-1,-1,-1,0,0,0
head of gnomevil,-1,-1,-1,-1,-1,-1,0,0,0
headache pill,399,10,423,10,18,3,389,38.9,1167
headchopper,50,50,0,0,0,0,0,0.0,0
health potion,80,65,68,58,2036,4777,15,0.23,30540
heart backpack,28800,8999,30346,14222,48,41,19801,2.2,811841
heart of the mountain (item),-1,-1,-1,-1,-1,-1,0,0,0
heart pillow,1299,1,1633,1,22,18,1298,1298.0,23364
heat core,9998,8930,9643,8878,22,200,1068,0.12,23496
heated worm punisher,-1,-1,-1,-1,-1,-1,0,0,0
heaven blossom,179,35,487,30,48,214,144,4.11,6912
heavily rusted armor,888,20,608,15,66,50,868,43.4,43400
heavily rusted helmet,11,11,0,0,0,0,0,0.0,0
heavily rusted legs,-1,10,932,10,26,4,-11,-1.1,-44
heavily rusted shield,-1,0,0,0,0,0,-1,0,0
heavy mace,49999,49580,54038,49518,7,127,419,0.01,2933
heavy machete,150,5,118,15,13,33,145,29.0,1885
heavy magic missile rune,-1,1,13,2,63,35,-2,-2.0,-70
heavy magic missile rune (weak),-1,-1,-1,-1,-1,-1,0,0,0
heavy metal t-shirt,44999,1000,48333,1000,3,2,43999,44.0,87998
heavy old tome,345,53,265,51,388,368,292,5.51,107456
heavy package,-1,0,0,0,0,0,-1,0,0
heavy stone hammer,-1,-1,-1,-1,-1,-1,0,0,0
heavy trident,1999,1960,1929,1821,12,147,39,0.02,468
hellforged axe,49979,27001,55610,32500,9,6,22978,0.85,137868
hellhound slobber,990,428,617,375,7,143,562,1.31,3934
hellspawn tail,740,404,620,409,291,426,336,0.83,97776
helmet adornment,0,1,0,1,0,1,-1,-1.0,0
helmet of nature,22999,0,24000,0,1,0,22999,0,0
helmet of the lost,4370,732,4425,518,3,15,3638,4.97,10914
helmet of ultimate terror,27665,10000,29998,6250,1,2,17665,1.77,17665
helmet ornament,0,10000,0,10000,0,1,-10000,-1.0,0
helmet piece,0,0,0,0,0,0,0,0,0
hemp rope,-1,-1,-1,-1,-1,-1,0,0,0
heroic axe,50,50,0,0,0,0,0,0.0,0
hexagonal ruby,30000,29700,30039,29590,1,608,300,0.01,300
hibiscus dress,2995,2965,2998,2965,3,476,30,0.01,90
hideous chunk,221,221,0,344,0,23,0,0.0,0
hieroglyph banner,9900,62,30346,173,8,10,9838,158.68,78704
high guard flag,750,476,571,470,4,100,274,0.58,1096
high guard shoulderplates,200,124,525,119,2,168,76,0.61,152
hive bow,47700,30028,52439,26243,9,8,17672,0.59,141376
hive scythe,16200,12437,16710,12160,24,47,3763,0.3,90312
hoe,6666,181,6666,453,1,8,6485,35.83,6485
hollow stampor hoof,7500,2222,5562,2235,21,32,5278,2.38,110838
holy amplification,311244,311244,638951,330555,10,9,0,0.0,0
holy ash,150,69,150,76,1,19,81,1.17,81
holy falcon,5000000,2778000,4567856,2989000,4,2,2222000,0.8,4444000
holy icon,8444000,5408004,8470332,6345000,3,3,3035996,0.56,9107988
holy missile rune,20,1,19,11,53,25,19,19.0,475
holy missile rune (weak),-1,-1,-1,-1,-1,-1,0,0,0
holy orchid,4487,1507,1604,1077,296,549,2980,1.98,882080
holy resilience,433563,433563,849953,533595,22,4,0,0.0,0
holy scarab,10000288,10000288,0,0,0,0,0,0.0,0
holy soil,-1,0,0,0,0,0,-1,0,0
honey flower,140,1,158,1,80,60,139,139.0,8340
honeycomb,6900,5628,6326,5185,1059,1477,1272,0.23,1347048
hook,77,77,0,84,0,223,0,0.0,0
horn (ring),-1,-1,-1,-1,-1,-1,0,0,0
horned helmet,100000,100000,0,0,0,0,0,0.0,0
horoscope,140,6,124,12,9,102,134,22.33,1206
horseman helmet,500,11,454,2,10,14,489,44.45,4890
horseshoe,420000,250000000,0,250000000,0,1,-249580000,-1.0,0
huge chunk of crude iron,14693,12737,14524,12545,117,741,1956,0.15,228852
huge shell,14091,14091,0,14284,0,3,0,0.0,0
huge spiky snail shell,7381,7780,0,7780,0,3,-399,-0.05,0
human teeth,19996,2036,36876,7455,33,23,17960,8.82,413080
humongous chunk,207,207,0,404,0,25,0,0.0,0
hunter's quiver,199,3,421,30,25,42,196,65.33,4900
hunting horn,4223333,2338000,3562556,2329674,7,3,1885333,0.81,5655999
hunting spear,58,12,34,8,95,153,46,3.83,4370
hydra egg,2200,150,2633,150,9,6,2050,13.67,12300
hydra head,597,519,585,500,15,670,78,0.15,1170
hydra tongue,50,50,1654,36,9,7,0,0.0,0
hydra tongue salad,89987,61332,110329,72488,347,138,28655,0.47,3954390
ice amplification,1500000,755888,1197106,791678,25,10,744112,0.98,7441120
ice cream cone (sprinkles),-1,-1,-1,-1,-1,-1,0,0,0
ice flower (item),-1,-1,-1,-1,-1,-1,0,0,0
ice flower seeds,40000,12000,32502,22344,19,7,28000,2.33,196000
ice hatchet,24900,5000,24900,5028,1,3,19900,3.98,19900
ice mammoth,79600,10033,34337,10005,10,3,69567,6.93,208701
ice pick,488,20,637,20,19,2,468,23.4,936
ice rapier,885,820,909,812,209,2768,65,0.08,13585
ice resilience,499888,300563,639302,339518,18,7,199325,0.66,1395275
ice shield,1299,35,1933,72,22,57,1264,36.11,27808
iced soil,15000,5125,14283,666,3,3,9875,1.93,29625
icicle (percht),-1,-1,-1,-1,-1,-1,0,0,0
icicle bow,69900,50000,57968,30618,53,18,19900,0.4,358200
icicle rune,35,20,33,11,210,53,15,0.75,795
icicle rune (weak),-1,-1,-1,-1,-1,-1,0,0,0
icy barbarian axe replica,50,50,0,0,0,0,0,0.0,0
icy blacksteel replica,50,50,0,0,0,0,0,0.0,0
icy clerical mace replica,50,50,39999,0,2,0,0,0.0,0
icy cranial basher replica,45000,50,45000,0,1,0,44950,899.0,0
icy crystal mace replica,50,50,0,0,0,0,0,0.0,0
icy culottes,27555555,20451000,29395672,21225499,6,2,7104555,0.35,14209110
icy dragon slayer replica,50,50,80000,50,1,1,0,0.0,0
icy headchopper replica,50,50,0,0,0,0,0,0.0,0
icy heroic axe replica,50,50,0,0,0,0,0,0.0,0
icy knight axe replica,50,50,0,0,0,0,0,0.0,0
icy mystic blade replica,60,60,0,0,0,0,0,0.0,0
icy orcish maul replica,50,50,0,0,0,0,0,0.0,0
icy rainbow shield,-1,-1,-1,-1,-1,-1,0,0,0
icy relic sword replica,50,50,0,0,0,0,0,0.0,0
icy spike sword replica,50,50,0,0,0,0,0,0.0,0
icy war axe replica,50,50,0,0,0,0,0,0.0,0
icy war hammer replica,39999,100,39999,0,1,0,39899,398.99,0
impaler,32999,10000,36638,9850,4,2,22999,2.3,45998
impaler of the igniter,5990000,3251000,6274277,2901000,2,1,2739000,0.84,2739000
incandescent crown,2799995,2229000,2826652,2128202,10,5,570995,0.26,2854975
incantation fragment,-1,0,0,0,0,0,-1,0,0
incantation notes,9998,8350,11041,7997,297,321,1648,0.2,489456
incredible mumpiz slayer,140000,100380,139950,157126,2,3,39620,0.39,79240
indoor plant kit,-1,0,0,0,0,0,-1,0,0
inert astral shaper rune,100000,100000,0,0,0,0,0,0.0,0
infernal bolt,22,19,17,14,1189,159,3,0.16,477
infernal heart,700,700,0,0,0,0,0,0.0,0
infernal robe,400,400,0,400,0,1,0,0.0,0
inkwell,450,450,0,419,0,25,0,0.0,0
inkwell (black),-1,-1,-1,-1,-1,-1,0,0,0
insectoid eggs,-1,0,6,0,4,0,-1,0,0
instable proto matter,202,279,10,152,278,249,-77,-0.28,-19173
intelligence reports,0,0,0,0,0,0,0,0,0
intense healing rune (item weak),-1,-1,-1,-1,-1,-1,0,0,0
intense healing rune (item),-1,-1,-1,-1,-1,-1,0,0,0
interdimensional potion,-1,0,0,0,0,0,-1,0,0
interwoven moss florets,-1,0,0,0,0,0,-1,0,0
invitation,-1,0,0,0,0,0,-1,0,0
iriana's chest,30000,30000,0,0,0,0,0,0.0,0
iron crown,3988000,2124000,3301559,2194183,16,11,1864000,0.88,20504000
iron hammer,0,100,0,100,0,6,-100,-1.0,0
iron helmet,-1,46,275,59,2,71,-47,-1.02,-94
iron loadstone,8500,500,2691,286,34,7,8000,16.0,56000
iron ore,537,465,527,433,318,1114,72,0.15,22896
ivory carving,279,164,279,254,5,272,115,0.7,575
ivory chair kit,100000,100000,0,0,0,0,0,0.0,0
ivory comb,7794,3000,7653,6881,8,266,4794,1.6,38352
izcandar's snow globe,157000,158000,280000,159000,2,2,-1000,-0.01,-2000
izcandar's sundial,0,183000,0,183000,0,1,-183000,-1.0,0
jacket,-1,500,0,500,0,1,-501,-1.0,0
jade hammer,26960,24380,28066,24259,5,171,2580,0.11,12900
jade hat,8795,8403,9021,7605,66,478,392,0.05,25872
jade zaoan bishop,999,100,999,3533,1,3,899,8.99,899
jade zaoan king,3800,100,2483,16733,2,3,3700,37.0,7400
jade zaoan knight,100,100,100,3400,1,3,0,0.0,0
jade zaoan pawn,4887,100,7039,2620,17,5,4787,47.87,23935
jade zaoan queen,125000,10000,138000,0,1,0,115000,11.5,0
jade zaoan rook,333,10000,216,10000,2,2,-9667,-0.97,-19334
jagged sickle,104800,104800,0,104700,0,4,0,0.0,0
jagged sword,132,1,97,1,15,55,131,131.0,1965
jalapeno pepper,64999,26200,59686,26795,144,39,38799,1.48,1513161
jar of honey,50000,0,60000,0,1,0,50000,0,0
jaul's pearl,95673,24045,455500,24173,2,3,71628,2.98,143256
jaws,414,414,480,409,1,185,0,0.0,0
jerom's family necklace,-1,0,0,0,0,0,-1,0,0
jester doll,47862,20010,47392,8370,6,3,27852,1.39,83556
jester hat,1900,0,1011,0,2,0,1900,0,0
jester staff,3499,1,3499,1,1,1,3498,3498.0,3498
jewel case,89000,2062,8181,2111,77,59,86938,42.16,5129342
jewel case (nomad),-1,-1,-1,-1,-1,-1,0,0,0
jewelled backpack,1500,401,1209,273,770,582,1099,2.74,639618
jewelled belt,67,67,0,99,0,20,0,0.0,0
jug of embalming fluid,1088,0,1074,0,116,0,1088,0,0
juice squeezer,697,1,781,1,86,32,696,696.0,22272
julius' map,990,1,4950,25,2,17,989,989.0,1978
jungle bow,4150000,3300000,3476023,2815653,9,6,850000,0.26,5100000
jungle flail,1800000,1100000,1581333,1100000,3,1,700000,0.64,700000
jungle quiver,5500000,3400000,4512601,3205500,13,4,2100000,0.62,8400000
jungle rod,1850000,1200004,2166663,1029494,6,1,649996,0.54,649996
jungle wand,1030000,1030000,1633331,1141800,3,5,0,0.0,0
katana,49,0,36,0,3,0,49,0,0
katex' blood,-1,-1,-1,-1,-1,-1,0,0,0
key of numerous locks (replica),-1,-1,-1,-1,-1,-1,0,0,0
key to knowledge,20000000,35000000,0,35000000,0,1,-15000000,-0.43,0
key to the drowned library,1110,45,1161,181,8,41,1065,23.67,8520
kitchen knife,444,1,603,9,79,20,443,443.0,8860
knife,-1,-1,-1,-1,-1,-1,0,0,0
knight armor,4855,4632,4871,4659,369,3858,223,0.05,82287
knight axe,50,50,0,0,0,0,0,0.0,0
knight legs,4999,4564,4910,4579,278,3463,435,0.1,120930
knight statue kit,100000,100000,0,0,0,0,0,0.0,0
kollos shell,201,201,0,210,0,15,0,0.0,0
kongra's shoulderpad,180,55,123,46,9,189,125,2.27,1125
kooldown-aid,988888,400000,1200894,708986,61,58,588888,1.47,34155504
koshei's ancient amulet,159590,117860,140230,105979,288,216,41730,0.35,9013680
krimhorn helmet,-1,1,1000,1,1,1,-2,-2.0,-2
lamassu hoof,307,235,306,250,7,482,72,0.31,504
lamassu horn,223,204,222,207,3,580,19,0.09,57
lancer beetle shell,350,11,844,9,2,39,339,30.82,678
lancet,290,19,714,22,4,99,271,14.26,1084
large amphora kit,100000,100000,0,0,0,0,0,0.0,0
large pliers,-1,-1,-1,-1,-1,-1,0,0,0
larvae,-1,0,4,0,10,0,-1,0,0
lavafungus head,300,300,0,537,0,8,0,0.0,0
lavafungus ring,130,130,0,208,0,13,0,0.0,0
lavaworm jaws,366,366,0,608,0,8,0,0.0,0
lavaworm spike roots,200,200,0,383,0,9,0,0.0,0
lavaworm spikes,250,250,0,307,0,7,0,0.0,0
lavos armor,323000,82227,324600,82227,1,1,240773,2.93,240773
leaf crown,3792984,2162005,3066242,2008667,15,5,1630979,0.75,8154895
leaf golem santa,90000,30100,88612,27900,4,3,59900,1.99,179700
leaf legs,399,1,338,14,9,15,398,398.0,3582
leaf star,64,20,70,40,89,447,44,2.2,3916
leather armor,-1,0,0,0,0,0,-1,0,0
leather boots,76,0,124,0,35,0,76,0,0
leather harness,-1,-1,-1,-1,-1,-1,0,0,0
leather helmet,100,0,100,0,2,0,100,0,0
leather legs,50,1,37,1,4,24,49,49.0,196
leather whip,13890,4817,14460,4452,73,45,9073,1.88,408285
leech,150000,50100,38704,9929,59,29,99900,1.99,2897100
left horn,0,0,0,0,0,0,0,0,0
legion helmet,13899,6009,18006,5310,69,49,7890,1.31,386610
legionnaire flags,-1,-1,-1,-1,-1,-1,0,0,0
legs of deathstrike,-1,-1,-1,-1,-1,-1,0,0,0
legs of gnomevil,-1,-1,-1,-1,-1,-1,0,0,0
lemon,-1,0,9,0,5,0,-1,0,0
lemon cupcake,300000,300001,0,300091,0,2,-1,-0.0,0
leopard armor,99,1,696,73,13,14,98,98.0,1274
letter to chantalle,-1,0,0,0,0,0,-1,0,0
letter to eremo,-1,0,0,0,0,0,-1,0,0
letter to markwin,-1,0,0,0,0,0,-1,0,0
letterbag,5555,5555,0,2000,0,1,0,0.0,0
leviathan's amulet,5998,3603,25695,6395,190,96,2395,0.66,229920
library ticket,40398000,34001000,40539333,33350000,9,3,6397000,0.19,19191000
lich staff,-1,0,0,0,0,0,-1,0,0
life crystal,148,86,121,78,64,1083,62,0.72,3968
life preserver,200,91,210,95,50,407,109,1.2,5450
life ring,318,208,255,167,4918,1596,110,0.53,175560
light mace,-1,0,0,0,0,0,-1,0,0
light magic missile rune,-1,1,21,1,23,17,-2,-2.0,-34
light magic missile rune (weak),-1,-1,-1,-1,-1,-1,0,0,0
light shovel,419,136,1186,410,763,213,283,2.08,60279
lightning boots,2990,2465,3220,2468,22,569,525,0.21,11550
lightning headband,2546,2455,2517,2418,45,2208,91,0.04,4095
lightning legs,11799,10780,11195,10849,72,1188,1019,0.09,73368
lightning pendant,1511,1470,1514,1472,435,2262,41,0.03,17835
lightning robe,11501,10870,11743,10886,29,290,631,0.06,18299
lightsphere,25555,2000,18481,4927,13,11,23555,11.78,259105
lilypad backpack,297600,110000,538216,251957,24,27,187600,1.71,4502400
liodile fang,100,310,0,310,0,6,-210,-0.68,0
lion amulet,1399899,1116000,1602258,1208779,39,39,283899,0.25,11072061
lion axe,1895666,1733001,2284559,1898444,29,36,162665,0.09,4717285
lion cloak patch,141,141,0,126,0,111,0,0.0,0
lion crest,216,216,998,209,4,107,0,0.0,0
lion figurine,9691,9381,9684,9429,7,200,310,0.03,2170
lion hammer,2901666,2018000,2508637,2064395,53,30,883666,0.44,26509980
lion longbow,1999000,1516003,2423816,2002224,39,47,482997,0.32,18836883
lion longsword,2799995,2512000,2616350,2176271,44,49,287995,0.11,12671780
lion plate,15997000,13114000,15209345,13795990,54,40,2883000,0.22,115320000
lion rod,2793000,2102000,2722099,2269319,58,55,691000,0.33,38005000
lion seal,80,80,0,0,0,0,0,0.0,0
lion shield,6293999,4262002,4837959,3808285,47,37,2031997,0.48,75183889
lion spangenhelm,7897000,7014005,7549126,6664983,54,46,882995,0.13,40617770
lion spellbook,5897000,5329007,6281690,5541417,39,47,567993,0.11,22151727
lion trophy,2005,2005,0,1455,0,16,0,0.0,0
lion wand,2993000,2503000,3216483,2748429,58,42,490000,0.2,20580000
lion's mane,80,33,143,26,246,389,47,1.42,11562
lisa's doll,18000000,18000000,0,0,0,0,0,0.0,0
lit crystal lamp,-1,-1,-1,-1,-1,-1,0,0,0
lit glowing mushroom,-1,-1,-1,-1,-1,-1,0,0,0
lit moon mirror,-1,-1,-1,-1,-1,-1,0,0,0
lit rainbow torch,-1,-1,-1,-1,-1,-1,0,0,0
lit small lamp,-1,-1,-1,-1,-1,-1,0,0,0
little bowl of myrrh,5427,4511,5619,4231,1794,483,916,0.2,442428
living armor,75800,25567,85678,40784,19,25,50233,1.96,954427
living vine bow,298000,186000,383439,303299,38,38,112000,0.6,4256000
lizard essence,300,266,769,261,4,134,34,0.13,136
lizard heart,947,315,1943,351,10,102,632,2.01,6320
lizard leather,921,367,1173,316,294,266,554,1.51,147364
lizard scale,786,498,1007,597,262,324,288,0.58,75456
lizard trophy,7976,4019,7658,3815,3,4,3957,0.98,11871
lizard weapon rack kit,100000,100000,0,0,0,0,0,0.0,0
lock pick,33,0,30,0,16,0,33,0,0
locker kit,-1,100000,0,100000,0,1,-100001,-1.0,0
longing eyes,6801,6801,0,7672,0,16,0,0.0,0
longsword,3178000,2603000,3408227,2884177,39,35,575000,0.22,20125000
lost basher's spike,-1,-1,-1,-1,-1,-1,0,0,0
lost bracers,48,48,0,70,0,28,0,0.0,0
lost husher's staff,-1,-1,-1,-1,-1,-1,0,0,0
lots,-1,-1,-1,-1,-1,-1,0,0,0
lottery ticket,3000,113,1345,113,28,1,2887,25.55,2887
love potion,10000,3,9833,3,4,2,9997,3332.33,19994
lucky pig,350000,100000,173600,106666,5,3,250000,2.5,750000
ludicrous piece of cloth,698,200,1031,59,74,25,498,2.49,12450
luminescent crystal pickaxe,25000,25000,0,0,0,0,0,0.0,0
luminous orb,980,803,980,792,1,490,177,0.22,177
luminous piece of cloth,1850,200,2273,44,79,23,1650,8.25,37950
lump of cake dough,300,1,423,6,26,74,299,299.0,7774
lump of chocolate dough,-1,0,0,0,0,0,-1,0,0
lump of clay,-1,0,0,0,0,0,-1,0,0
lump of dirt,23,1,36,4,16,197,22,22.0,352
lump of dough,8000,1,9000,1,1,1,7999,7999.0,7999
lump of earth,197,109,130,107,11,438,88,0.81,968
lump of garlic dough,10000,10000,10000,10000,1,1,0,0.0,0
lump of holy water dough,-1,10000,0,10000,0,1,-10001,-1.0,0
lump of reed flour dough,-1,0,0,0,0,0,-1,0,0
lump of sacred clay,-1,0,0,0,0,0,-1,0,0
lunar staff,4900,3232,4687,3137,26,91,1668,0.52,43368
lute,0,2,0,2,0,15,-2,-1.0,0
lyre,-1,0,155,0,31,0,-1,0,0
mace,9449,8870,9466,8638,3,722,579,0.07,1737
mace of carving,-1,-1,-1,-1,-1,-1,0,0,0
mace of destruction,547000,301800,548022,300700,3,2,245200,0.81,490400
mace of mayhem,-1,-1,-1,-1,-1,-1,0,0,0
mace of remedy,-1,-1,-1,-1,-1,-1,0,0,0
machete,150,5,118,15,13,33,145,29.0,1885
machine crate,-1,0,0,0,0,0,-1,0,0
mad froth,250,1,250,13,1,22,249,249.0,249
mage hat,980,1,2139,51,44,40,979,979.0,39160
mage's cap,34000000,31005000,35591089,33146715,8,7,2995000,0.1,20965000
magic crystal,0,10,0,10,0,3,-10,-1.0,0
magic light wand,98,9,182,9,176,137,89,9.89,12193
magic longsword,999999,999999,0,0,0,0,0,0.0,0
magic plate armor,92999,89090,92942,89094,264,346,3909,0.04,1031976
magic shield potion,28597,25042,32547,22863,704,225,3555,0.14,799875
magic sulphur,7791,7780,8656,7685,180,728,11,0.0,1980
magic sword,299999,150020,267024,219428,163,120,149979,1.0,17997480
magic wall rune,-1,113,119,113,2022,363,-114,-1.01,-41382
magical cage key,90000,100,90000,100,1,1,89900,899.0,89900
magical inkwell,-1,0,0,0,0,0,-1,0,0
magical measurement device,-1,10000,0,10000,0,1,-10001,-1.0,0
magical watch,-1,0,0,0,0,0,-1,0,0
magician hat,139898,21721,131484,21600,6,1,118177,5.44,118177
magician's robe,49,0,48,0,3,0,49,0,0
magma amulet,1518,1475,1533,1465,1553,2871,43,0.03,66779
magma boots,2524,2470,2525,2466,142,2178,54,0.02,7668
magma clump,-1,-1,-1,-1,-1,-1,0,0,0
magma coat,11070,10870,10944,10672,175,2718,200,0.02,35000
magma legs,11949,10880,11633,10818,281,2055,1069,0.1,300389
magma monocle,2508,2470,2515,2470,102,2178,38,0.02,3876
mago mechanic core,36000,1900,36346,0,5,0,34100,17.95,0
maimer,75000,35000,79754,45515,5,4,40000,1.14,160000
major crystalline token,134,96,153,93,33,207,38,0.4,1254
make-do boots,20500000,18021000,21110749,18638250,12,4,2479000,0.14,9916000
makeshift boots,19750000,18559000,21778857,18994000,7,5,1191000,0.06,5955000
malice's horn,518000,518000,0,545500,0,4,0,0.0,0
malice's spine,708000,768000,0,768000,0,2,-60000,-0.08,0
mallet handle,249000,10455,249000,0,1,0,238545,22.82,0
mallet head,5000000,5000000,0,5027728,0,2,0,0.0,0
mallet pommel,1900000,1500000,2700000,1500000,1,1,400000,0.27,400000
malofur's lunchbox,227801,227801,0,228680,0,4,0,0.0,0
mammoth fur cape,6666,5780,6111,5454,16,302,886,0.15,14176
mammoth fur shorts,300,300,0,317,0,4,0,0.0,0
mammoth tusk,95,42,223,57,4,274,53,1.26,212
mammoth whopper,390,10,275,160,6,156,380,38.0,2280
mana potion,146,142,145,142,5026,4578,4,0.03,18312
mandrake,4999,2290,40968,3023,13,33,2709,1.18,35217
mango,93,1,89,1,109,2,92,92.0,184
mantassin tail,201,201,0,207,0,124,0,0.0,0
manticore ear,-1,-1,-1,-1,-1,-1,0,0,0
manticore tail,-1,-1,-1,-1,-1,-1,0,0,0
map to the unknown,1585,55,1397,42,113,10,1530,27.82,15300
marble floor,75000,33,67500,20,4,1,74967,2271.73,74967
marked crate,500,10,957,10,5,1,490,49.0,490
marlin,15000,100,11499,972,4,11,14900,149.0,59600
marlin trophy,44444,2596,32412,2679,7,3,41848,16.12,125544
marsh stalker beak,75,22,99,18,1,138,53,2.41,53
marsh stalker feather,942,502,1476,1212,206,452,440,0.88,90640
master archer's armor,170000,135700,226885,193462,72,68,34300,0.25,2332400
mastermind potion,509,491,517,479,2681,2308,18,0.04,41544
mastermind shield,50898,49510,50855,49529,450,673,1388,0.03,624600
maxilla,2003,2003,0,2750,0,4,0,0.0,0
maxilla maximus,665999,400100,664976,551160,16,12,265899,0.66,3190788
maxxen santa,99900,20100,78283,16300,6,3,79800,3.97,239400
maxxenius head,311000,388000,0,388000,0,1,-77000,-0.2,0
meat,98,1,426,97,167,43,97,97.0,4171
meat shield,50000,10000,50000,10000,1,1,40000,4.0,40000
meaty vortex,0,1000,0,1000,0,2,-1000,-1.0,0
mechanical fish,2748,0,2712,0,7,0,2748,0,0
mechanical fishing rod,1995,91,1998,88,7,4,1904,20.92,7616
medal of valiance,368000,368000,0,368222,0,9,0,0.0,0
medicine pouch,6400,4902,6184,4665,877,889,1498,0.31,1313746
medusa shield,9999,8900,9423,8899,112,1055,1099,0.12,123088
medusa skull (replica),-1,-1,-1,-1,-1,-1,0,0,0
megalomania's essence,900000,900000,0,900000,0,1,0,0.0,0
megalomania's skull,700000,700000,0,0,0,0,0,0.0,0
melon,26,2,26,2,6,18,24,12.0,144
melting horn,66100,22010,68872,22429,8,18,44090,2.0,352720
memory crystal,64499,0,66500,0,1,0,64499,0,0
memory stone,-1,0,19500,0,3,0,-1,0,0
menacing egg,2700000,2700000,0,0,0,0,0,0.0,0
mercenary sword,11999,11890,13618,11875,27,1394,109,0.01,2943
meringue cake,100,1,289,3,27,35,99,99.0,2673
message in a bottle,-1,0,0,0,0,0,-1,0,0
metal bat,9500,8514,11687,8201,10,146,986,0.12,9860
metal fitting,5500,300,1987,0,22,0,5200,17.33,0
metal jaw,-1,-1,-1,-1,-1,-1,0,0,0
metal spats,2333,1776,4220,1683,13,212,557,0.31,7241
metal spike,484,334,1230,574,277,136,150,0.45,20400
metal toe,46,46,0,36,0,16,0,0.0,0
midnight sarong,14966537,13022000,19949868,14742207,11,15,1944537,0.15,21389907
midnight shard,4998,3333,5495,3003,27,69,1665,0.5,44955
midnight tunic,6797000,4539000,7533748,6071302,16,20,2258000,0.5,36128000
might ring,5195,4950,5369,4986,3482,1724,245,0.05,422380
mighty helm of green sparks,25001,25001,0,12000,0,1,0,0.0,0
mind stone,160,140,158,118,8,466,20,0.14,160
mini mummy,51599,26000,51281,26000,5,3,25599,0.98,76797
mining helmet,100,0,99,0,4,0,100,0,0
mining helmet (budrik),-1,-1,-1,-1,-1,-1,0,0,0
mino lance,6960,5167,6636,6360,17,184,1793,0.35,30481
mino shield,2989,2740,2872,2683,43,1173,249,0.09,10707
minor crystalline token,9665,7701,10514,9110,376,316,1964,0.26,620624
minotaur backpack,2554,351,2786,196,56,35,2203,6.28,77105
minotaur horn,89,67,71,60,31,855,22,0.33,682
minotaur leather,89,51,124,65,345,778,38,0.75,13110
minotaur statue kit,-1,0,0,0,0,0,-1,0,0
minotaur trophy,499,289,476,249,14,236,210,0.73,2940
miraculum,389,12,602,21,9,148,377,31.42,3393
mirror,666779,666779,2199997,0,2,0,0,0.0,0
model ship,1999,400,1464,294,6,32,1599,4.0,9594
modified crossbow,10200,5620,12211,7613,31,64,4580,0.81,141980
molten plate,16400000,75000000,0,75000000,0,1,-58600000,-0.78,0
molten wax,21499,13,17737,16,15,4,21486,1652.77,85944
monkey statue 'hear' kit,42999,0,50000,0,1,0,42999,0,0
monkey statue 'see' kit,45999,0,50000,0,1,0,45999,0,0
monkey statue 'speak' kit,-1,0,0,0,0,0,-1,0,0
mooh'tah plate,6996,5628,5921,5512,15,429,1368,0.24,20520
mooh'tah shell,594,202,644,323,377,516,392,1.94,147784
moohtant cudgel,27665,13081,14845,13115,19,30,14584,1.11,277096
moohtant horn,11695,7714,10787,8131,349,205,3981,0.52,816105
moon backpack,42794,17500,52406,27730,90,70,25294,1.45,1770580
moon flower,436,1,444,1,2,7,435,435.0,870
moon mirror,14999,13600,15042,6839,543,252,1399,0.1,352548
moonlight crystals,81,43,149,34,1052,318,38,0.88,12084
moonlight rod,400,120,739,140,146,748,280,2.33,40880
moonstone,12680,12431,12829,11863,15,345,249,0.02,3735
morbid tapestry,20001,20001,0,0,0,0,0,0.0,0
morgaroth's heart,14444444,5000000,14172222,2000000,2,1,9444444,1.89,9444444
morik's helmet,20000,150,41999,0,1,0,19850,132.33,0
morning star,299,45,218,36,6,183,254,5.64,1524
mortal mace,99827,50001,183770,104977,18,14,49826,1.0,697564
mossmasher figurine,80000,1111,145053,9690,1,6,78889,71.01,78889
mother soil,-1,400,0,400,0,2,-401,-1.0,0
mould heart,1101,1101,0,1249,0,7,0,0.0,0
mould robe,400,400,0,601,0,3,0,0.0,0
mouldy cheese,44,0,60,0,48,0,44,0,0
mouldy powder,1300,159,315,149,10,193,1141,7.18,11410
mr. punish's handcuffs,0,0,0,0,0,0,0,0,0
muck remover,10001,10001,0,0,0,0,0,0.0,0
muck rod,6000,5759,6046,5724,39,1583,241,0.04,9399
mucus plug,350,202,481,132,10,160,148,0.73,1480
mug,155555,155555,0,0,0,0,0,0.0,0
mummy disguise,-1,0,0,0,0,0,-1,0,0
mushroom backpack,1350,233,2324,323,90,85,1117,4.79,94945
mushroom pie,50,3,119,3,130,42,47,15.67,1974
mushroom spores,60000,220,58518,0,3,0,59780,271.73,0
music box,1500000,1112223,1562739,1135825,54,17,387777,0.35,6592209
music box (replica),-1,-1,-1,-1,-1,-1,0,0,0
music sheet (first verse),-1,-1,-1,-1,-1,-1,0,0,0
music sheet (fourth verse),-1,-1,-1,-1,-1,-1,0,0,0
music sheet (second verse),-1,-1,-1,-1,-1,-1,0,0,0
music sheet (third verse),-1,-1,-1,-1,-1,-1,0,0,0
musician's bow,15000,34,29996,0,1,0,14966,440.18,0
mutant bone boots,59000000,25000000,59000000,0,1,0,34000000,1.36,0
mutant bone kilt,45000000,20000000,77000000,27333333,1,3,25000000,1.25,25000000
mutated bat ear,272,272,443,308,15,134,0,0.0,0
mutated flesh,134,40,292,36,10,157,94,2.35,940
mutated rat tail,-1,-1,-1,-1,-1,-1,0,0,0
mutated skin armor,60000000,22077999,60000000,0,1,0,37922001,1.72,0
mutated skin legs,750000,750000,0,0,0,0,0,0.0,0
mycological bow,35492,32720,35925,30724,42,106,2772,0.08,116424
mycological mace,19931,1590,16412,1941,17,15,18341,11.54,275115
mysterious fetish,40,1,47,2,9,108,39,39.0,351
mysterious remains,1695,1432,1782,1311,169,886,263,0.18,44447
mysterious voodoo skull,4999,2520,4330,2640,43,142,2479,0.98,106597
mystic blade,39999,50,40000,0,1,0,39949,798.98,0
mystic root,3790,0,6993,0,2,0,3790,0,0
mystic turban,298,180,260,135,18,388,118,0.66,2124
mystical hourglass,841,658,1387,701,490,263,183,0.28,48129
mythril axe,27000000,13000000,27000000,0,1,0,14000000,1.08,0
naga axe,1999995,1702000,2572581,2360926,10,13,297995,0.18,2979950
naga basin,-1,-1,-1,-1,-1,-1,0,0,0
naga club,2478000,1358000,2017199,1327234,16,12,1120000,0.82,13440000
naga crossbow,8294000,6804000,8454550,7554000,26,25,1490000,0.22,37250000
naga quiver,12991000,8054000,9659636,7411666,11,9,4937000,0.61,44433000
naga rod,2426000,1602000,2483792,1980894,23,18,824000,0.51,14832000
naga sword,13993000,11748000,14176598,12748723,20,18,2245000,0.19,40410000
naga wand,1991992,1600000,2111545,1639601,20,25,391992,0.24,7839840
naginata,18244,1210,18122,1044,2,9,17034,14.08,34068
nail,948,437,507,434,11,588,511,1.17,5621
nail case,489999,310400,468205,290289,9,5,179599,0.58,897995
native armor,-1,0,0,0,0,0,-1,0,0
natural soil,19440,1215,19417,2027,4,2,18225,15.0,36450
nature magic spellbook,-1,0,0,0,0,0,-1,0,0
nautical map,-1,0,0,0,0,0,-1,0,0
necklace of the deep,3344,3050,4306,3438,1278,677,294,0.1,199038
necromancer shield,118977,86730,149033,100790,51,44,32247,0.37,1418868
necromantic robe,-1,-1,-1,-1,-1,-1,0,0,0
necromantic rust,370,208,363,225,8,158,162,0.78,1296
necrotic rod,980,814,1113,777,137,1324,166,0.2,22742
net,0,2,0,12,0,2,-2,-1.0,0
net (fishing),-1,-1,-1,-1,-1,-1,0,0,0
nettle blossom,5000,40,2900,40,4,8,4960,124.0,19840
nettle spit,0,1,0,4,0,22,-1,-1.0,0
neutral matter,-1,0,0,0,0,0,-1,0,0
nightmare beast santa,102001,102001,99750,22580,2,4,0,0.0,0
nightmare blade,34998,34680,35936,34762,12,1158,318,0.01,3816
nightmare hook,23400,6667,16985,0,2,0,16733,2.51,0
nightmare horn,11997000,9000000,13663000,10404400,3,5,2997000,0.33,8991000
nightmare shield,214998,111753,228812,178039,52,41,103245,0.92,4233045
nightmare teddy,29999,10005,23550,12483,7,6,19994,2.0,119964
noble amulet,368000,387000,0,389750,0,4,-19000,-0.05,0
noble armor,500,500,2757,160,7,20,0,0.0,0
noble axe,10446,9880,10150,9784,36,1200,566,0.06,20376
noble cape,358000,358000,0,364666,0,6,0,0.0,0
noble sword (replica),-1,-1,-1,-1,-1,-1,0,0,0
noble turban,143,331,0,331,0,7,-188,-0.57,0
nomad parchment,1549,20,1457,9,51,13,1529,76.45,19877
norse shield,3497,405,3279,394,5,22,3092,7.63,15460
norseman doll (replica),-1,-1,-1,-1,-1,-1,0,0,0
northern fishburger,4000,480,2575,500,17,11,3520,7.33,38720
northern pike,58999,40015,60857,38438,132,131,18984,0.47,2486904
northern star,225000,3350,158750,0,4,0,221650,66.16,0
northwind rod,1700,1328,1759,1265,127,1033,372,0.28,47244
nose ring,1896000,1060007,1652902,1351247,33,16,835993,0.79,13375888
note from the thieves guild,-1,0,0,0,0,0,-1,0,0
notes and coordinates,-1,-1,-1,-1,-1,-1,0,0,0
observer tapestry,17997,6000,16677,3822,19,23,11997,2.0,227943
obsidian knife,16000,8260,17002,8306,367,220,7740,0.94,1702800
obsidian lance,650,301,866,256,88,347,349,1.16,30712
obsidian truncheon,14919,12000,29721,10826,8,14,2919,0.24,23352
obsidian zaoan bishop,0,1,0,2525,0,4,-1,-1.0,0
obsidian zaoan king,1000,2,760,5001,2,2,998,499.0,1996
obsidian zaoan knight,3900,2,3900,1684,2,6,3898,1949.0,7796
obsidian zaoan pawn,18887,2000,21943,614,2,7,16887,8.44,33774
obsidian zaoan queen,54000,10000,54999,1,2,1,44000,4.4,44000
obsidian zaoan rook,4886,2,4666,4020,3,5,4884,2442.0,14652
obujos' shell,7051000,7704000,11741246,8502251,4,4,-653000,-0.08,-2612000
obvious piece of cloth,3331,300,4418,371,67,33,3031,10.1,100023
oceanborn leviathan armor,25000000,23500000,25000000,23500000,1,1,1500000,0.06,1500000
odd hat,1000,1000,38999,1000,3,1,0,0.0,0
odd organ,994,250,504,280,11,138,744,2.98,8184
ogre choppa,900,899,1215,868,9,122,1,0.0,9
ogre ear stud,0,102,0,107,0,203,-102,-1.0,0
ogre klubba,2197,1315,2371,1320,6,110,882,0.67,5292
ogre nose ring,479,202,790,192,96,200,277,1.37,26592
ogre scepta,3400,2119,3313,1966,11,61,1281,0.6,14091
oil lamp,-1,0,0,0,0,0,-1,0,0
old and used backpack,5000000,3104000,4897666,2700000,3,1,1896000,0.61,1896000
old cape,59999,30000,65990,26872,8,7,29999,1.0,209993
old encrypted text,-1,0,0,0,0,0,-1,0,0
old girtablilu carapace,254,254,0,445,0,7,0,0.0,0
old iron,0,0,0,0,0,0,0,0,0
old parchment,468,252,422,251,7,129,216,0.86,1512
old pirate poem,-1,0,0,0,0,0,-1,0,0
old power core,62000,0,48316,0,6,0,62000,0,0
old rag,896,300,2230,451,141,177,596,1.99,84036
old royal diary,288500,186000,585000,178825,1,8,102500,0.55,102500
ominous piece of cloth,999,200,1299,45,73,17,799,4.0,13583
one hit wonder,13337,13337,0,0,0,0,0,0.0,0
onion,598,0,398,0,6,0,598,0,0
onyx arrow,-1,7,8,7,923,278,-8,-1.14,-2224
onyx chip,500,491,501,490,4,1134,9,0.02,36
onyx flail,23890,20544,22968,20492,8,418,3346,0.16,26768
onyx pendant,6198,3381,4084,3381,34,150,2817,0.83,95778
opal,-1,-1,-1,-1,-1,-1,0,0,0
orange,4999,2000,8431,1451,15,26,2999,1.5,44985
orange backpack,120,15,79,8,152,210,105,7.0,15960
orange bag,788,1,3570,1,11,12,787,787.0,8657
orange fireworks powder,270,14,152,9,14,58,256,18.29,3584
orange fireworks rocket,-1,-1,-1,-1,-1,-1,0,0,0
orange mushroom,298,71,298,94,4,49,227,3.2,908
orange star,2950,2,2800,2,3,5,2948,1474.0,8844
orange tapestry,-1,2,0,2,0,4,-3,-1.5,0
orb,4999000,2227000,3845500,2106000,6,1,2772000,1.24,2772000
orc leather,29,2,26,13,9,345,27,13.5,243
orc tooth,568,320,996,428,291,444,248,0.78,72168
orc trophy,11,11,0,51,0,7,0,0.0,0
orc tusk,500,10,837,5,5,27,490,49.0,2450
orc's jaw shredder (replica),-1,-1,-1,-1,-1,-1,0,0,0
orcish axe,488,106,420,133,74,129,382,3.6,28268
orcish gear,80,54,78,70,13,208,26,0.48,338
orcish maul,50,50,5000,0,2,0,0,0.0,0
orclops santa,120000,25100,137859,23155,5,4,94900,3.78,379600
orichalcum pearl,30,22,36,21,73,326,8,0.36,584
oriental shoes,15299,14810,15301,14203,80,634,489,0.03,39120
ornamented axe,44900,18100,29156,19068,10,10,26800,1.48,268000
ornamented brooch,14899,4801,17059,4817,45,27,10098,2.1,272646
ornamented shield,6000,500,13870,174,6,3,5500,11.0,16500
ornate carving axe,10000,0,79500,0,1,0,10000,0,0
ornate carving blade,0,0,0,0,0,0,0,0,0
ornate carving chopper,0,0,0,0,0,0,0,0,0
ornate carving hammer,22900,100,38975,100,2,1,22800,228.0,22800
ornate carving mace,0,0,0,0,0,0,0,0,0
ornate carving rod,24000,0,24998,0,6,0,24000,0,0
ornate carving slayer,0,0,0,0,0,0,0,0,0
ornate carving wand,28999,0,29500,0,10,0,28999,0,0
ornate chestplate,5497000,5197100,5528027,5037489,93,80,299900,0.06,23992000
ornate crossbow,11686,8272,11135,8231,139,393,3414,0.41,474546
ornate legs,74100,50800,99371,81429,85,94,23300,0.46,1980500
ornate locket,17530,17530,33394,17231,2,37,0,0.0,0
ornate mace,180000,50000,223983,52500,6,2,130000,2.6,260000
ornate mayhem axe,9999,0,72900,0,1,0,9999,0,0
ornate mayhem blade,0,0,0,0,0,0,0,0,0
ornate mayhem chopper,0,0,0,0,0,0,0,0,0
ornate mayhem hammer,89900,0,89900,0,1,0,89900,0,0
ornate mayhem mace,1899,0,3999,0,1,0,1899,0,0
ornate mayhem rod,195000,1000,103283,1000,3,1,194000,194.0,194000
ornate mayhem slayer,2000,0,3349,0,2,0,2000,0,0
ornate mayhem wand,-1,0,28444,0,9,0,-1,0,0
ornate remedy axe,9999,20000,40000,20000,1,1,-10001,-0.5,-10001
ornate remedy blade,0,0,0,0,0,0,0,0,0
ornate remedy chopper,9999,0,33950,0,1,0,9999,0,0
ornate remedy hammer,4990,0,4990,0,1,0,4990,0,0
ornate remedy mace,0,0,0,0,0,0,0,0,0
ornate remedy rod,27000,0,27060,0,7,0,27000,0,0
ornate remedy slayer,0,0,0,0,0,0,0,0,0
ornate remedy wand,26000,0,25141,0,7,0,26000,0,0
ornate shield,133000,92360,144380,98454,95,61,40640,0.44,2479040
orshabaal's brain,-1,0,8000000,0,1,0,-1,0,0
oven kit,100000,100000,0,0,0,0,0,0.0,0
oven spatula,-1,0,0,0,0,0,-1,0,0
package of potions,-1,0,0,0,0,0,-1,0,0
pair of dreamwalkers,2098990,1252004,2313737,1829552,86,68,846986,0.68,57595048
pair of earmuffs,1499,501,1390,682,11,77,998,1.99,10978
pair of hellflayer horns,779,779,1244,920,10,83,0,0.0,0
pair of iron fists,4000,2556,3913,2533,10,149,1444,0.56,14440
pair of nightmare boots,294702,246600,292710,227497,156,143,48102,0.2,6878586
pair of old bracers,403,403,0,402,0,1,0,0.0,0
pair of soulstalkers,148699,117052000,131186109,123750761,24,21,-116903301,-1.0,-2454969321
pair of soulwalkers,157000,150000000,159457704,152455941,20,17,-149843000,-1.0,-2547331000
paladin armor,16299,14850,16481,14909,322,265,1449,0.1,383985
pale worm's scalp,409000,409000,0,409000,0,7,0,0.0,0
pan,12879992,10115000,14288624,11282000,24,16,2764992,0.27,44239872
pannier backpack,93998,33400,74842,14929,15,6,60598,1.81,363588
panpipes,142,46,160,46,44,72,96,2.09,4224
panther head,105000,105000,0,0,0,0,0,0.0,0
panther paw,78900,10000,88687,8980,1,4,68900,6.89,68900
paralyse rune,650,264,460,267,486,164,386,1.46,63304
parcel,24,1,19,1,374,53,23,23.0,1219
parcel (watchtower),-1,-1,-1,-1,-1,-1,0,0,0
part of a rune (five),-1,-1,-1,-1,-1,-1,0,0,0
part of a rune (four),-1,-1,-1,-1,-1,-1,0,0,0
part of a rune (one),-1,-1,-1,-1,-1,-1,0,0,0
part of a rune (six),-1,-1,-1,-1,-1,-1,0,0,0
part of a rune (three),-1,-1,-1,-1,-1,-1,0,0,0
part of a rune (two),-1,-1,-1,-1,-1,-1,0,0,0
party cake,50,5,1948,5,18,2,45,9.0,90
party hat,25,0,22,0,7,0,25,0,0
party lampions (green),-1,-1,-1,-1,-1,-1,0,0,0
party lampions (red),-1,-1,-1,-1,-1,-1,0,0,0
party wall snake,2502,2502,0,0,0,0,0,0.0,0
party wall tinsel,30000,30000,0,0,0,0,0,0.0,0
patch of fine cloth,1989,936,2530,991,25,76,1053,1.12,26325
patched boots,700,700,0,0,0,0,0,0.0,0
paw amulet,-1,0,0,0,0,0,-1,0,0
peacock feather fan,412,281,487,280,26,406,131,0.47,3406
peanut,9934,8359,9059,7750,108,204,1575,0.19,170100
pear,297,275,366,258,77,1476,22,0.08,1694
peas,-1,0,0,0,0,0,-1,0,0
peg leg,8826,4233,10362,8580,111,184,4593,1.09,509823
pelvis bone,150,50,164,21,193,279,100,2.0,19300
pendulet,4491000,3338005,4289271,3568374,25,24,1152995,0.35,27671880
pendulum clock kit,100000,100000,0,0,0,0,0,0.0,0
percht broom,20000,25000,100000,25000,1,2,-5000,-0.2,-5000
percht handkerchief,20000,1,20000,10000,1,2,19999,19999.0,19999
percht queen's frozen heart,40000,6000,48610,5800,4,8,34000,5.67,136000
percht skull,149900,60100,193572,110253,298,128,89800,1.49,11494400
percht-warding torch,-1,-1,-1,-1,-1,-1,0,0,0
perfect behemoth fang,4292,3900,5844,4112,367,300,392,0.1,117600
pet pig,4000,1,2007,42,7,8,3999,3999.0,27993
petrified scream,650,256,2411,210,62,83,394,1.54,24428
phantasmal axe,199997,146000,379407,167166,44,30,53997,0.37,1619910
phantasmal hair,166,166,0,322,0,3,0,0.0,0
pharaoh banner,999,336,826,569,47,198,663,1.97,31161
pharaoh sword,13337,12001000,0,12001000,0,1,-11987663,-1.0,0
phoenix charm,444440,101221,201755,99167,182,51,343219,3.39,17504169
phoenix egg,28000,11020,25857,11060,15,4,16980,1.54,67920
phoenix shield,114882,16000,67137,51233,8,8,98882,6.18,791056
phoenix statue (replica),-1,-1,-1,-1,-1,-1,0,0,0
physical amplification,1300000,425525,1335076,680446,19,7,874475,2.06,6121325
physical resilience,1298999,390465,896363,497084,11,3,908534,2.33,2725602
piano kit,100000,100000,0,0,0,0,0,0.0,0
pick,142,52,141,85,3,73,90,1.73,270
picture (landscape),-1,-1,-1,-1,-1,-1,0,0,0
picture (portrait),-1,-1,-1,-1,-1,-1,0,0,0
picture (still life),-1,-1,-1,-1,-1,-1,0,0,0
piece of archer armor,45,17,31,12,2,124,28,1.65,56
piece of cactus,20000,10,20000,10,2,2,19990,1999.0,39980
piece of crocodile leather,10,1,9,4,37,274,9,9.0,333
piece of dead brain,15930,14335,15730,14329,2003,552,1595,0.11,880440
piece of draconian steel,2899,2388,3030,2256,130,344,511,0.21,66430
piece of hell steel,455,200,541,220,55,303,255,1.27,14025
piece of hellfire armor,-1,-1,-1,-1,-1,-1,0,0,0
piece of iron,-1,1,0,1,0,158,-2,-2.0,0
piece of marble rock,5000,5000,5027,2851,111,221,0,0.0,0
piece of massacre's shell,10000,10000,385000,0,1,0,0,0.0,0
piece of royal satin,988,5,974,6,132,4,983,196.6,3932
piece of royal steel,9678,9402,9963,9103,123,342,276,0.03,33948
piece of scarab shell,1140,650,1516,937,201,328,490,0.75,98490
piece of swampling wood,5995,4510,5313,3906,851,795,1485,0.33,1180575
piece of warrior armor,54,41,55,33,1,158,13,0.32,13
pieces of magic chalk,332,166,339,163,21,127,166,1.0,3486
piercing bolt,-1,1,5,1,36,99,-2,-2.0,-72
pig foot,35,250,0,250,0,12,-215,-0.86,0
piggy bank,487,260,660,264,143,295,227,0.87,32461
pile of grave earth,548,365,2532,279,101,128,183,0.5,18483
pillow backpack,250000,81597,172948,102714,55,42,168403,2.06,7072926
pinata,-1,-1,-1,-1,-1,-1,0,0,0
pinch of crystal dust,332,0,332,0,1,0,332,0,0
pineapple,-1,0,199,0,1,0,-1,0,0
pirat's tail,197,129,168,118,13,349,68,0.53,884
pirate backpack,749,456,1194,359,155,171,293,0.64,45415
pirate bag,480,1,181,1,106,10,479,479.0,4790
pirate boots,28000,2640,6580,2555,96,71,25360,9.61,1800560
pirate coin,149,100,162,97,14,494,49,0.49,686
pirate hat,1799,476,2974,465,74,58,1323,2.78,76734
pirate knee breeches,280,63,383,61,74,105,217,3.44,16058
pirate shirt,950,260,1436,247,75,86,690,2.65,51750
pirate tapestry,2597,1,1652,10,13,13,2596,2596.0,33748
pirate treasure map,-1,0,0,0,0,0,-1,0,0
pirate voodoo doll,1000,253,432,278,192,514,747,2.95,143424
pirate's surprise,-1,0,0,0,0,0,-1,0,0
pitchfork,0,0,0,0,0,0,0,0,0
plague bell,24000,4610,34495,16853,75,24,19390,4.21,465360
plague bite,3825018,3825018,0,0,0,0,0,0.0,0
plague mask,14444,6401,26626,7167,81,30,8043,1.26,241290
plagueroot offshoot,208000,238000,0,254560,0,5,-30000,-0.13,0
plain carving axe,-1,0,0,0,0,0,-1,0,0
plain carving blade,-1,0,0,0,0,0,-1,0,0
plain carving chopper,-1,0,0,0,0,0,-1,0,0
plain carving hammer,-1,0,0,0,0,0,-1,0,0
plain carving mace,-1,0,0,0,0,0,-1,0,0
plain carving rod,-1,0,20000,0,1,0,-1,0,0
plain carving slayer,-1,0,0,0,0,0,-1,0,0
plain carving wand,-1,0,20000,0,1,0,-1,0,0
plain mayhem axe,-1,0,0,0,0,0,-1,0,0
plain mayhem blade,-1,0,0,0,0,0,-1,0,0
plain mayhem chopper,0,0,0,0,0,0,0,0,0
plain mayhem hammer,-1,0,0,0,0,0,-1,0,0
plain mayhem mace,-1,0,0,0,0,0,-1,0,0
plain mayhem rod,0,0,0,0,0,0,0,0,0
plain mayhem slayer,-1,0,0,0,0,0,-1,0,0
plain mayhem wand,-1,0,20000,0,1,0,-1,0,0
plain remedy axe,-1,0,0,0,0,0,-1,0,0
plain remedy blade,-1,0,0,0,0,0,-1,0,0
plain remedy chopper,-1,0,0,0,0,0,-1,0,0
plain remedy hammer,-1,0,0,0,0,0,-1,0,0
plain remedy mace,-1,0,0,0,0,0,-1,0,0
plain remedy rod,-1,0,0,0,0,0,-1,0,0
plain remedy slayer,0,0,0,0,0,0,0,0,0
plain remedy wand,-1,0,0,0,0,0,-1,0,0
plan for a makeshift armour,26767000,23001000,27690750,21026000,4,4,3766000,0.16,15064000
plans for a strange device,-1,0,0,0,0,0,-1,0,0
plasma pearls,226,226,666,221,11,166,0,0.0,0
plasmatic lightning,251,180,251,211,2,250,71,0.39,142
plate,980000,400200,978616,400453,5,4,579800,1.45,2319200
plate armor,92999,89090,92942,89094,264,346,3909,0.04,1031976
plate legs,187,96,388,87,327,550,91,0.95,29757
plate shield,52,12,45,10,11,102,40,3.33,440
platinum amulet,3500,2445,2520,2431,425,2152,1055,0.43,448375
plum,888888,511000,914151,530491,4,8,377888,0.74,1511552
plushie of a deepling,1500000,400530,1294666,0,3,0,1099470,2.75,0
plushie of a hydra,2109000,1170000,2264666,1176666,3,3,939000,0.8,2817000
plushie of devovorga,1000000,564400,1265966,0,3,0,435600,0.77,0
plushie of gaz'haragoth,1374600,819003,1257233,854050,3,2,555597,0.68,1111194
plushie of king tibianus,1500000,1002000,1282666,1002000,3,1,498000,0.5,498000
plushie of lavaworm,3200000,2000000,3300000,2000000,2,2,1200000,0.6,2400000
plushie of tentugly,224770,100000,379229,237240,3,9,124770,1.25,374310
poem scroll,949,2,945,2,45,4,947,473.5,3788
poet's fencing quill,0,0,0,0,0,0,0,0,0
pointed rabbitslayer,15000,0,17499,0,1,0,15000,0,0
poison arrow,-1,1,2,1,28,125,-2,-2.0,-56
poison bomb rune,85,50,91,60,439,143,35,0.7,5005
poison dagger,3,0,3,0,1,0,3,0,0
poison field rune,-1,1,9,1,43,9,-2,-2.0,-18
poison salt crystal,-1,-1,-1,-1,-1,-1,0,0,0
poison spider shell,0,1,0,2,0,52,-1,-1.0,0
poison wall rune,40,20,48,16,68,49,20,1.0,980
poisoned fang,120,77,120,106,12,392,43,0.56,516
poisonous slime,50,1,45,32,35,799,49,49.0,1715
polar bear paw,4000,2161,5292,2195,89,72,1839,0.85,132408
pomegranate,3950,53,2191,74,56,89,3897,73.53,218232
pool of chitinous glue,330,330,0,316,0,113,0,0.0,0
porcelain mask,12490,4005,11931,3515,12,12,8485,2.12,101820
post horn,993,2,774,2,2,15,991,495.5,1982
post officer's hat,500,0,428,0,7,0,500,0,0
pot,1999,1000,6332,1000,6,4,999,1.0,3996
pot of blackjack,249961,148610,211374,179145,249,78,101351,0.68,7905378
potato,19,1,24,1,6,39,18,18.0,108
potted flower,0,2,0,2,0,6,-2,-1.0,0
powder herb,1799,454,1418,322,19,54,1345,2.96,25555
power bolt,-1,1,9,5,200,406,-2,-2.0,-400
power ring,40,1,39,5,68,291,39,39.0,2652
precious necklace,0,0,0,0,0,0,0,0,0
premium scroll,-1,0,0,0,0,0,-1,0,0
prepared bucket,222,55,759,38,42,20,167,3.04,3340
prickly pear,-1,4,34,4,2,30,-5,-1.25,-10
prismatic armor,2994,1380,4928,1813,324,175,1614,1.17,282450
prismatic bolt,21,19,20,19,100,86,2,0.11,172
prismatic boots,943,104,1188,693,90,59,839,8.07,49501
prismatic helmet,3205,1410,4077,1238,81,53,1795,1.27,95135
prismatic legs,2442,515,2977,1229,129,89,1927,3.74,171503
prismatic necklace,17509,15929,19755,15433,1606,728,1580,0.1,1150240
prismatic quartz,520,405,567,389,2,335,115,0.28,230
prismatic ring,74957,69182,71579,64044,4252,714,5775,0.08,4123350
prismatic shield,3997,759,3556,703,76,36,3238,4.27,116568
prison cell key,10000,10000,0,0,0,0,0,0.0,0
pristine worm head,6902,6902,0,5380,0,5,0,0.0,0
protection amulet,74,35,99,55,188,656,39,1.11,7332
protective charm,1640,1601,2318,1987,2480,1651,39,0.02,64389
psychedelic tapestry,200000,60400,127674,67661,21,7,139600,2.31,977200
pulverized ore,367,250,374,240,7,102,117,0.47,819
pumpkin,40,1,88,1,1,4,39,39.0,39
pure energy,23997,0,23998,0,1,0,23997,0,0
purple backpack,838,22,298,16,128,152,816,37.09,104448
purple bag,800,0,874,0,36,0,800,0,0
purple fireworks powder,765,14,729,9,19,55,751,53.64,14269
purple fireworks rocket,-1,-1,-1,-1,-1,-1,0,0,0
purple kiss blossom,55000,40,36388,40,4,1,54960,1374.0,54960
purple nightshade blossoms,2898,1201,6633,1374,159,59,1697,1.41,100123
purple powder,-1,0,0,0,0,0,-1,0,0
purple robe,154,100,216,104,6,499,54,0.54,324
purple tapestry,488,2,519,2,1,7,486,243.0,486
purple tendril lantern,5984,153,4033,480,67,54,5831,38.11,314874
purple tome,1800,1290,1777,1187,23,303,510,0.4,11730
quara bone,899,448,693,430,9,173,451,1.01,4059
quara eye,326,314,326,309,1,182,12,0.04,12
quara pincers,799,351,485,342,4,177,448,1.28,1792
quara tentacle,184,99,184,107,1,159,85,0.86,85
queen's sceptre,200000,80103,299999,80252,1,2,119897,1.5,119897
quill,0,0,0,0,0,0,0,0,0
quiver,177499,152000000,175866922,159341200,13,10,-151822501,-1.0,-1518225010
rabbit's foot,9999,10000,9999,10000,1,1,-1,-0.0,-1
rabbit's foot lucky charm,7998,102,8995,82,1,4,7896,77.41,7896
raccoon backpack,2393000,1400000,2078339,1385000,5,2,993000,0.71,1986000
raccoon santa,99000,20000,165971,30620,7,6,79000,3.95,474000
ragnir helmet,-1,1,0,1,0,2,-2,-2.0,0
rainbow necklace,723900,456215,739854,573487,66,72,267685,0.59,17667210
rainbow quartz,465,465,535,469,3,651,0,0.0,0
rainbow shield,3949990,2527000,3447887,3188807,9,10,1422990,0.56,12806910
rainbow torch,9211000,6000000,8312500,7000333,4,3,3211000,0.54,9633000
rainbow trout,1197,601,1990,368,88,60,596,0.99,35760
rake,0,50,0,223,0,36,-50,-1.0,0
ranger legs,100,0,66,0,3,0,100,0,0
ranger's cloak,0,0,0,0,0,0,0,0,0
rapier,885,820,909,812,209,2768,65,0.08,13585
rare crystal,20,20,0,0,0,0,0,0.0,0
rare earth,-1,52,76,65,14,382,-53,-1.02,-742
raspberry,98,1,200,1,3,9,97,97.0,291
rat cheese,-1,0,1,0,3,0,-1,0,0
rat god doll,1666,70,1638,112,9,8,1596,22.8,12768
ratana,300,231,409,202,84,431,69,0.3,5796
ratmiral's hat,200000,138700,200000,132567,1,39,61300,0.44,61300
ravager's axe,6875664,6875664,0,0,0,0,0,0.0,0
raven herb,79,79,9462,80,6,2,0,0.0,0
ravenous circlet,199600,51000,199600,147938,1,6,148600,2.91,148600
ravenwing,2810005,2810005,0,0,0,0,0,0.0,0
raw watermelon tourmaline,49999,35103,51963,38004,74,218,14896,0.42,1102304
reagent flask,0,0,0,0,0,0,0,0,0
reaper's axe,2997777,2301000,2912259,1250000,3,1,696777,0.3,696777
red apple,49,1,35,1,54,181,48,48.0,2592
red backpack,87,1,263,16,176,91,86,86.0,7826
red bag,511,0,473,0,33,0,511,0,0
red balloons,0,1,0,16,0,40,-1,-1.0,0
red bed kit,-1,-1,-1,-1,-1,-1,0,0,0
red crystal fragment,799,786,761,743,17,1602,13,0.02,221
red cushioned chair kit,-1,100000,0,100000,0,1,-100001,-1.0,0
red dragon leather,1900,1182,2164,1176,310,643,718,0.61,222580
red dragon scale,275,160,559,172,230,500,115,0.72,26450
red fireworks powder,438,14,2050,10,13,56,424,30.29,5512
red fireworks rocket,-1,-1,-1,-1,-1,-1,0,0,0
red gem,998,997,998,992,19,5947,1,0.0,19
red gingerbread heart,166456,166456,1500000,0,1,0,0,0.0,0
red goanna scale,153,153,0,193,0,126,0,0.0,0
red hair dye,555,1,555,7,1,38,554,554.0,554
red lantern,230,77,328,134,7,135,153,1.99,1071
red mushroom,-1,0,1,0,6,0,-1,0,0
red paint,-1,-1,-1,-1,-1,-1,0,0,0
red piece of cloth,340,246,435,240,280,995,94,0.38,26320
red pillow,-1,2,78,2,6,6,-3,-1.5,-18
red pit demon,1337,1337,0,0,0,0,0,0.0,0
red powder,-1,0,0,0,0,0,-1,0,0
red quiver,550,15,732,14,132,23,535,35.67,12305
red robe,440,15,625,93,15,96,425,28.33,6375
red rose,67,2,62,3,27,16,65,32.5,1040
red silk flower,49978,30830,69043,27793,37,19,19148,0.62,363812
red tapestry,99,1,97,1,72,12,98,98.0,1176
red teleport crystal,119999,44222,103848,44127,36,9,75777,1.71,681993
red tome,1990,700,2758,683,11,49,1290,1.84,14190
red tunic,-1,0,0,0,0,0,-1,0,0
reed balls,-1,0,0,0,0,0,-1,0,0
reflecting crown,2570000,1602000,2561541,1537001,7,1,968000,0.6,968000
reins,4040000,1536000,2827799,1765800,15,9,2504000,1.63,22536000
relic sword,50,50,0,50,0,1,0,0.0,0
replica of the sceptre,5000,0,8199,0,4,0,5000,0,0
rerun's ring,-1,0,0,0,0,0,-1,0,0
research notes,6999,150,6247,150,4,1,6849,45.66,6849
resizer,78314,30076,96661,49190,27,19,48238,1.6,916522
resonance crystal,-1,0,0,0,0,0,-1,0,0
resonance crystal (recorded),-1,-1,-1,-1,-1,-1,0,0,0
reward box,5000000,900000,4250000,900000,2,1,4100000,4.56,4100000
rhindeer antlers,236,236,0,418,0,30,0,0.0,0
rhino hide,58,101,0,101,0,1,-43,-0.43,0
rhino horn,88,88,520,0,1,0,0,0.0,0
rhino horn carving,-1,-1,-1,-1,-1,-1,0,0,0
rhodolith necklace,355555,355555,0,0,0,0,0,0.0,0
rice ball,15,15,33,11,5,8,0,0.0,0
rift bow,46999,44430,50438,43936,96,250,2569,0.06,246624
rift crossbow,46998,44370,49339,44514,75,268,2628,0.06,197100
rift lance,31759,29430,31549,29521,12,222,2329,0.08,27948
rift shield,50899,49390,50720,49419,29,215,1509,0.03,43761
rift tapestry,10,1,21,1,32,172,9,9.0,288
right horn,-1,0,0,0,0,0,-1,0,0
ring of blue plasma,8081,7801,8073,7736,2621,1768,280,0.04,495040
ring of ending,4900,3900,4036,3440,24,63,1000,0.26,24000
ring of green plasma,19499,17028,20690,17005,3652,1211,2471,0.15,2992381
ring of healing,847,709,913,759,2973,2070,138,0.19,285660
ring of red plasma,8350,8130,9039,8349,1885,1296,220,0.03,285120
ring of souls,755800,652800,979445,698557,43,34,103000,0.16,3502000
ring of souls (depleted),-1,-1,-1,-1,-1,-1,0,0,0
ring of the sky,30599,29470,30498,29494,70,437,1129,0.04,79030
ring of wishes,-1,0,0,0,0,0,-1,0,0
ripper lance,5000,50,5414,1,7,1,4950,99.0,4950
ritual scissors,4999,150,4999,150,4,1,4849,32.33,4849
ritual tooth,1000,50,4990,82,1,77,950,19.0,950
roasted dragon wings,4200,2000,5160,1769,99,109,2200,1.1,217800
roasted meat,0,2,0,2,0,16,-2,-1.0,0
robe of the ice queen,17000000,50000000,0,50000000,0,1,-33000000,-0.66,0
robe of the underworld,94200,55600,113276,62461,44,35,38600,0.69,1351000
rocking chair kit,-1,0,0,0,0,0,-1,0,0
rocking horse kit,100000,100000,0,0,0,0,0,0.0,0
rod (creature product),-1,-1,-1,-1,-1,-1,0,0,0
rod of carving,-1,-1,-1,-1,-1,-1,0,0,0
rod of destruction,749999,250911,738257,549501,42,30,499088,1.99,14972640
rod of mayhem,-1,-1,-1,-1,-1,-1,0,0,0
rod of remedy,-1,-1,-1,-1,-1,-1,0,0,0
roll,90,1,71,7,2,56,89,89.0,178
rolling pin,0,0,0,0,0,0,0,0,0
ron the ripper's sabre,648300,461306,814791,580080,8,10,186994,0.41,1495952
roots,620,552,619,557,2,157,68,0.12,136
rope,38998,16501,37170,18479,64,38,22497,1.36,854886
rope belt,2850,2445,3125,2794,3994,2303,405,0.17,932715
rorc egg,28,8,28,12,2,40,20,2.5,40
rorc feather,126,744,40,2,643,308,-618,-0.83,-190344
rose shield,-1,0,0,0,0,0,-1,0,0
rotten demonbone,179000,75000,181666,75000,3,1,104000,1.39,104000
rotten feather,-1,55,399,77,3,114,-56,-1.02,-168
rotten heart,69000,69000,0,67582,0,93,0,0.0,0
rotten heart of a tree,-1,0,0,0,0,0,-1,0,0
rotten piece of cloth,30,20,28,18,8,409,10,0.5,80
rotten witches' cauldron seed,3333,3333,0,1000,0,1,0,0.0,0
rotworm stew,409964,380610,455223,393127,213,122,29354,0.08,3581188
round blue pillow,0,0,0,0,0,0,0,0,0
round purple pillow,-1,0,0,0,0,0,-1,0,0
round red pillow,0,0,0,0,0,0,0,0,0
round table kit,100000,100000,0,0,0,0,0,0.0,0
round turquoise pillow,-1,0,0,0,0,0,-1,0,0
royal axe,40000,38720,39154,29922,20,14,1280,0.03,17920
royal crossbow,154000,114601,186595,131033,20,19,39399,0.34,748581
royal draken mail,220000,188200,224183,180997,28,20,31800,0.17,636000
royal fanfare,-1,0,0,0,0,0,-1,0,0
royal helmet,30000,29380,30381,29274,97,750,620,0.02,60140
royal scale robe,398400,301800,487138,367638,126,111,96600,0.32,10722600
royal spear,22,1,21,9,410,270,21,21.0,5670
royal star,-1,1,3,1,283,1612,-2,-2.0,-566
royal tapestry,9999,1,9399,1733,5,6,9998,9998.0,49990
rubber cap,13450,10555,12320,10571,9,233,2895,0.27,26055
ruby necklace,2399,1870,2499,1880,2,307,529,0.28,1058
rum flask,300,0,541,0,83,0,300,0,0
runed sword,59900,34600,45144,33069,36,41,25300,0.73,910800
runic ice shield,4989,315,12253,372,5,5,4674,14.84,23370
rusted armor,888,20,608,15,66,50,868,43.4,43400
rusted helmet,11,11,0,0,0,0,0,0.0,0
rusted legs,-1,10,932,10,26,4,-11,-1.1,-44
rusted shield,-1,0,0,0,0,0,-1,0,0
rusty winged helmet,300,1,700,1,1,1,299,299.0,299
ruthless axe,49999,44230,49956,44045,3,142,5769,0.13,17307
sabre,648300,461306,814791,580080,8,10,186994,0.41,1495952
sabretooth,4080,3890,4405,4075,2446,926,190,0.05,175940
sacred antler talisman,38999,0,29499,0,5,0,38999,0,0
sacred bowl,-1,0,0,0,0,0,-1,0,0
sacred bowl of purification,-1,0,0,0,0,0,-1,0,0
sacred earth,-1,0,0,0,0,0,-1,0,0
sacred tree amulet,3200,2971,3949,3022,617,2801,229,0.08,141293
safety pin,64,64,99,78,2,55,0,0.0,0
sai,16496,15781,15621,15389,82,1386,715,0.05,58630
salamander shield,0,0,0,0,0,0,0,0,0
salmon,-1,0,619,0,4,0,-1,0,0
salt,-1,-1,-1,-1,-1,-1,0,0,0
sample of sand wasp honey,997,2,1246,2,121,8,995,497.5,7960
sample of venorean spice,-1,0,394,0,112,0,-1,0,0
sandals,890000,300000,882092,300000,9,2,590000,1.97,1180000
sandcrawler shell,13000,12500,12873,12342,61,282,500,0.04,30500
sandfish,14000,11200,14000,11200,1,3,2800,0.25,2800
sandscourge figurine,97000,5000,105874,4839,4,6,92000,18.4,368000
santa ahau,199888,55100,324000,0,5,0,144788,2.63,0
santa backpack,44333,20901,33270,23256,81,24,23432,1.12,562368
santa fox,94000,46500,102780,36400,8,3,47500,1.02,142500
santa hat,44990,7201,18305,7322,15,8,37789,5.25,302312
santa leech,119000,13000,100000,10000,3,2,106000,8.15,212000
santa teddy,78900,50000,124244,44993,5,11,28900,0.58,144500
sapphire amulet,6995,298,6452,1524,9,8,6697,22.47,53576
sapphire hammer,8000,6400,9717,6522,25,147,1600,0.25,40000
sapphire necklace,800000,350000,775000,0,2,0,450000,1.29,0
saw,7,0,61,0,20,0,7,0,0
scale armor,70,33,73,25,19,112,37,1.12,703
scale from a frozen dragon,15555,15555,0,0,0,0,0,0.0,0
scale of corruption,748,502,705,498,142,132,246,0.49,32472
scarab amulet,199,120,173,114,21,473,79,0.66,1659
scarab coin,105,65,179,82,606,558,40,0.62,22320
scarab pincers,275,228,274,223,11,489,47,0.21,517
scarab shield,1993,1955,1992,1955,3,262,38,0.02,114
scarf,198,5,248,5,86,52,193,38.6,10036
sceptre part (cusp),-1,-1,-1,-1,-1,-1,0,0,0
sceptre part (emerald),-1,-1,-1,-1,-1,-1,0,0,0
sceptre part (shaft),-1,-1,-1,-1,-1,-1,0,0,0
scimitar,56,56,115,56,111,143,0,0.0,0
scorpion charm,503,503,0,505,0,13,0,0.0,0
scorpion sceptre,1499900,1010204,1462121,1031739,23,6,489696,0.48,2938176
scorpion tail,99,1,352,11,12,299,98,98.0,1176
screaming cherry,-1,250,0,250,0,1,-251,-1.0,0
scribbled sheet of paper,1000,0,1000,0,1,0,1000,0,0
scroll (tbi),-1,-1,-1,-1,-1,-1,0,0,0
scroll of ascension,17900,1,12033,749,25,20,17899,17899.0,357980
scroll of heroic deeds,230,187,246,178,10,469,43,0.23,430
scrubbing brush,397000,300006,355411,297118,31,17,96994,0.32,1648898
scum bag,8000,0,5500,0,4,0,8000,0,0
scythe,16200,12437,16710,12160,24,47,3763,0.3,90312
scythe leg,850,331,467,326,20,391,519,1.57,10380
scythe of the reaper,700000,122222,870000,0,2,0,577778,4.73,0
sea horse figurine,41700,40901,41615,40523,4,204,799,0.02,3196
sea serpent scale,500,401,491,411,5,120,99,0.25,495
sea serpent trophy,9900,5122,10297,4953,14,13,4778,0.93,62114
seacrest hair,8500,1506,4498,1343,81,37,6994,4.64,258778
seacrest pearl,1500,1,1330,1,10,2,1499,1499.0,2998
seacrest scale,-1,1,0,1,0,5,-2,-2.0,0
seashell book (blue),-1,-1,-1,-1,-1,-1,0,0,0
seashell book (green),-1,-1,-1,-1,-1,-1,0,0,0
seashell book (yellow),-1,-1,-1,-1,-1,-1,0,0,0
secret letter,-1,0,0,0,0,0,-1,0,0
sedge hat,95000,35100,124155,31623,6,3,59900,1.71,179700
seeds,150,38,150,36,1,95,112,2.95,112
sentinel shield,-1,1500,0,1500,0,8,-1501,-1.0,0
serpent crest,1990,120,6543,373,10,10,1870,15.58,18700
serpent sword,839,737,810,677,206,1511,102,0.14,21012
shadow cowl,10391000,8000000,12838996,10505691,10,9,2391000,0.3,21519000
shadow herb,799,12,157,7,29,171,787,65.58,22823
shadow mask,250,350,0,350,0,26,-100,-0.29,0
shadow orb,690,230,948,230,4,3,460,2.0,1380
shadow paint,380,380,0,350,0,5,0,0.0,0
shadow sceptre,9949,9380,9613,9192,104,1448,569,0.06,59176
shaggy ogre bag,-1,0,0,0,0,0,-1,0,0
shaggy tail,0,1,0,8,0,38,-1,-1.0,0
shamanic hood,75,21,105,19,1,184,54,2.57,54
shamanic mask,1553,1200,1553,1054,3,75,353,0.29,1059
shamanic talisman,229,137,299,131,1,147,92,0.67,92
shapechanger,20000,1,23000,1,1,5,19999,19999.0,19999
shapeshifter ring,17999,100,19738,100,12,2,17899,178.99,35798
shard,1496,1482,1498,1478,4,1234,14,0.01,56
shark fins,159,159,0,156,0,274,0,0.0,0
shell (item),-1,-1,-1,-1,-1,-1,0,0,0
shield of care,100000,2647,101000,0,1,0,97353,36.78,0
shield of corruption,1142899,914503,1098501,974200,39,27,228396,0.25,6166692
shield of honour,500000,435000,500000000,0,1,0,65000,0.15,0
shield of the white knight,1001,1001,0,7333,0,3,0,0.0,0
shimmer ball,10,100,0,100,0,1,-90,-0.9,0
shimmer glower,0,0,0,0,0,0,0,0,0
shimmer swimmer,100000,7389,129801,0,2,0,92611,12.53,0
shimmering beetles,130,130,0,124,0,146,0,0.0,0
shining sun catcher,-1,-1,-1,-1,-1,-1,0,0,0
shiny blade,69100,25000,92670,53130,44,42,44100,1.76,1852200
shiny stone,800,326,1246,323,44,205,474,1.45,20856
shiver arrow,-1,3,5,3,98,52,-4,-1.33,-208
shockwave amulet,6699,4052,9232,7510,396,605,2647,0.65,1048212
shopping bag,38,1,31,1,320,219,37,37.0,8103
short sword,0,0,0,0,0,0,0,0,0
shoulder plate,3916000,3409003,3987029,3522173,66,58,506997,0.15,29405826
shovel,419,136,1186,410,763,213,283,2.08,60279
shrimp,7775,1701,8394,2403,51,26,6074,3.57,157924
shroud of despair,43500000,30001000,44195000,30001000,1,1,13499000,0.45,13499000
shrunken head necklace,32700000,26105000,33258400,27078250,5,4,6595000,0.25,26380000
sickle,700,381,719,376,44,382,319,0.84,14036
sight of surrender's eye,4999,1002,6023,2401,10,19,3997,3.99,39970
sight of surrender's plushie,248900,130000,295478,132402,4,5,118900,0.91,475600
signed contract,-1,0,0,0,0,0,-1,0,0
signet ring,408000,408000,0,416000,0,5,0,0.0,0
silencer claws,2444,2066,2633,2253,3683,1388,378,0.18,524664
silencer resonating chamber,788,472,2450,463,10,351,316,0.67,3160
silken bookmark,932,932,0,917,0,79,0,0.0,0
silkweaver bow,27900,13000,35394,11953,24,15,14900,1.15,223500
silky fur,400,2,1507,8,12,71,398,199.0,4776
silky tapestry,28,1,37,1,8,41,27,27.0,216
silver amulet,20,5,70,5,169,312,15,3.0,2535
silver brooch,151,143,149,141,6,908,8,0.06,48
silver dagger,201,480,14,191,477,200,-279,-0.58,-55800
silver hand mirror,9690,9581,9552,8952,8,210,109,0.01,872
silver mace,13500000,13500000,0,0,0,0,0,0.0,0
silver necklace,600000,600000,0,0,0,0,0,0.0,0
silver prison key,496300,154600,339199,102472,6,5,341700,2.21,1708500
silver raid token,49898,38078,57172,39704,85,78,11820,0.31,921960
silver rune emblem (animate dead),-1,-1,-1,-1,-1,-1,0,0,0
silver rune emblem (avalanche),-1,-1,-1,-1,-1,-1,0,0,0
silver rune emblem (chameleon),-1,-1,-1,-1,-1,-1,0,0,0
silver rune emblem (destroy field),-1,-1,-1,-1,-1,-1,0,0,0
silver rune emblem (disintegrate),-1,-1,-1,-1,-1,-1,0,0,0
silver rune emblem (energy bomb),-1,-1,-1,-1,-1,-1,0,0,0
silver rune emblem (energy wall),-1,-1,-1,-1,-1,-1,0,0,0
silver rune emblem (explosion),-1,-1,-1,-1,-1,-1,0,0,0
silver rune emblem (fire field),-1,-1,-1,-1,-1,-1,0,0,0
silver rune emblem (fireball),-1,-1,-1,-1,-1,-1,0,0,0
silver rune emblem (firebomb),-1,-1,-1,-1,-1,-1,0,0,0
silver rune emblem (great fireball),-1,-1,-1,-1,-1,-1,0,0,0
silver rune emblem (heavy magic missile),-1,-1,-1,-1,-1,-1,0,0,0
silver rune emblem (holy missile),-1,-1,-1,-1,-1,-1,0,0,0
silver rune emblem (icicle),-1,-1,-1,-1,-1,-1,0,0,0
silver rune emblem (light magic missile),-1,-1,-1,-1,-1,-1,0,0,0
silver rune emblem (magic wall),-1,-1,-1,-1,-1,-1,0,0,0
silver rune emblem (paralyze),-1,-1,-1,-1,-1,-1,0,0,0
silver rune emblem (poison bomb),-1,-1,-1,-1,-1,-1,0,0,0
silver rune emblem (soulfire),-1,-1,-1,-1,-1,-1,0,0,0
silver rune emblem (sudden death),-1,-1,-1,-1,-1,-1,0,0,0
silver rune emblem (thunderstorm),-1,-1,-1,-1,-1,-1,0,0,0
silver rune emblem (ultimate healing),-1,-1,-1,-1,-1,-1,0,0,0
silver rune emblem (wild growth),-1,-1,-1,-1,-1,-1,0,0,0
silver token,29400,28233,28804,26633,4189,2793,1167,0.04,3259431
simple arrow,-1,0,2,0,15,0,-1,0,0
simple dress,45,1,52,1,5,7,44,44.0,220
simple fanfare,-1,1,0,1,0,3,-2,-2.0,0
single human eye,998,741,952,805,26,254,257,0.35,6682
siramal's golden bug trophy,115400,115400,0,0,0,0,0,0.0,0
skeleton decoration,2900,1806,2864,2487,21,215,1094,0.61,22974
skull (item),-1,-1,-1,-1,-1,-1,0,0,0
skull belt,389,15,278,16,10,104,374,24.93,3740
skull fetish,236,146,327,144,5,175,90,0.62,450
skull helmet,39592,39430,39542,38425,11,382,162,0.0,1782
skull of a caveman,0,10000,0,10000,0,1,-10000,-1.0,0
skull of ratha,800,0,1974,0,4,0,800,0,0
skull shatterer,58,58,0,78,0,24,0,0.0,0
skull staff,5950,5833,5955,5825,53,1998,117,0.02,6201
skullcracker armor,18950,17280,19573,17281,25,361,1670,0.1,41750
skullcrusher,194069,56565,70322,45537,8,3,137504,2.43,412512
skunk tail,-1,1,1200,14,1,9,-2,-2.0,-2
slayer of carving,-1,-1,-1,-1,-1,-1,0,0,0
slayer of destruction,2800000,1003000,1695798,1292223,39,22,1797000,1.79,39534000
slayer of mayhem,-1,-1,-1,-1,-1,-1,0,0,0
slayer of remedy,-1,-1,-1,-1,-1,-1,0,0,0
sleep shawl,1049900,910027,1062698,904643,136,86,139873,0.15,12029078
slightly rusted armor,2498,1450,2596,1227,124,338,1048,0.72,129952
slightly rusted helmet,13993,1210,18329,1132,11,85,12783,10.56,140613
slightly rusted legs,1497,1066,2831,1020,47,146,431,0.4,20257
slightly rusted shield,4895,1206,5216,1784,21,87,3689,3.06,77469
slime gobbler,500,3,919,3,9,6,497,165.67,2982
slime heart,150,88,145,79,30,369,62,0.7,1860
slime mould,12999,7210,13436,6988,114,58,5789,0.8,335762
slimy leaf tentacle,-1,-1,-1,-1,-1,-1,0,0,0
slimy leg,3281,3281,0,3167,0,3,0,0.0,0
sling herb,14,14,53,8,19,121,0,0.0,0
slingshot,67900,33340,58166,32384,69,22,34560,1.04,760320
sliver,13000,11066,14440,13305,456,1493,1934,0.17,881904
slug drug,1200000,715100,1257849,861822,22,9,484900,0.68,4364100
small amethyst,205,196,203,185,192,2175,9,0.05,1728
small axe,-1,0,0,0,0,0,-1,0,0
small blue pillow,50,0,49,0,2,0,50,0,0
small diamond,300,297,298,291,27,2138,3,0.01,81
small emerald,290,246,294,239,1523,2490,44,0.18,67012
small enchanted amethyst,229,197,209,175,74,963,32,0.16,2368
small enchanted emerald,259,247,261,245,103,845,12,0.05,1236
small enchanted ruby,279,247,295,245,105,730,32,0.13,3360
small enchanted sapphire,259,247,263,240,78,630,12,0.05,936
small energy ball,101,101,0,141,0,3,0,0.0,0
small flask of eyedrops,872,33,293,42,13,241,839,25.42,10907
small golden anchor,145000,4000,57088,4114,12,7,141000,35.25,987000
small green pillow,-1,0,0,0,0,0,-1,0,0
small health potion,57552,2515,51888,2501,12,15,55037,21.88,660444
small ice statue (bird),-1,-1,-1,-1,-1,-1,0,0,0
small ice statue (fish),-1,-1,-1,-1,-1,-1,0,0,0
small ladybug,9999,1235,15005,3427,6,10,8764,7.1,52584
small lamp,8500,2,9249,2,4,3,8498,4249.0,25494
small notebook,-1,-1,-1,-1,-1,-1,0,0,0
small oil lamp,550,52,647,80,2,14,498,9.58,996
small orange pillow,-1,0,0,0,0,0,-1,0,0
small pitchfork,17,17,149,20,2,31,0,0.0,0
small purple pillow,-1,0,1000,0,1,0,-1,0,0
small red pillow,-1,0,0,0,0,0,-1,0,0
small ruby,260,247,262,238,266,1825,13,0.05,3458
small sapphire,260,247,283,245,247,2249,13,0.05,3211
small stone,188,19,41,19,124,324,169,8.89,20956
small table kit,100000,100000,0,0,0,0,0,0.0,0
small topaz,199,197,233,191,88,1485,2,0.01,176
small treasure chest,172,999,15,10,790,401,-827,-0.83,-331627
small turquoise pillow,-1,0,0,0,0,0,-1,0,0
small whistle,-1,0,0,0,0,0,-1,0,0
small white pillow,0,0,0,0,0,0,0,0,0
smoking coal,8787,300,9921,302,15,4,8487,28.29,33948
snake destroyer,25000,325,18944,143,9,14,24675,75.92,222075
snake god trophy,390000,390000,0,0,0,0,0,0.0,0
snake god's sceptre,13900,2002,17800,3901,1,8,11898,5.94,11898
snake god's wristguard,21444,7255,20963,6649,49,43,14189,1.96,610127
snake sceptre,95000,0,73976,0,2,0,95000,0,0
snake skin,488,346,887,384,416,797,142,0.41,59072
snakebite rod,80,31,194,72,71,468,49,1.58,3479
sneaky stabber of eliteness,624996,347200,439616,336492,86,53,277796,0.8,14723188
sneaky stabber of eliteness (jammed),-1,-1,-1,-1,-1,-1,0,0,0
sniper arrow,-1,1,8,2,208,125,-2,-2.0,-250
sniper gloves,4450,1503,6143,1528,55,57,2947,1.96,162085
snow flake tapestry,88900,6964,80161,4275,9,8,81936,11.77,655488
snowball,170,1,301,30,134,356,169,169.0,22646
snowbash figurine,97000,11000,109935,12370,4,3,86000,7.82,258000
snowman doll,59900,18123,42869,11417,9,6,41777,2.31,250662
soap,349999,230000,297706,224100,30,19,119999,0.52,2279981
sofa chair kit,100000,100000,0,0,0,0,0,0.0,0
soft cheese,7,1,100,1,1,28,6,6.0,6
solar axe,1600000,1600000,0,0,0,0,0,0.0,0
soldier helmet,123,1,115,2,13,51,122,122.0,1586
solitude charm,16665,7004,17469,8291,338,92,9661,1.38,888812
some golden fruits,17000,1,26332,1,3,6,16999,16999.0,50997
some grimeleech wings,1299,1207,1599,1285,3178,375,92,0.08,34500
some mushrooms,-1,0,0,0,0,0,-1,0,0
some mushrooms (brown),-1,-1,-1,-1,-1,-1,0,0,0
some special leaves,-1,0,0,0,0,0,-1,0,0
soul contract,1000,500,1209,439,104,26,500,1.0,13000
soul net,40000,10000,39557,10000,7,1,30000,3.0,30000
soul orb,35,30,37,33,47,1981,5,0.17,235
soul stone,10800,3716,15099,5388,78,77,7084,1.91,545468
soulbastion,41999000,39037000,44146823,39880875,17,16,2962000,0.08,47392000
soulbiter,32947000,28712000,33917909,30465611,22,18,4235000,0.15,76230000
soulbleeder,346400,301313001,331316766,311577769,20,13,-300966601,-1.0,-3912565813
soulcrusher,26973000,21504000,25536000,22094083,12,12,5469000,0.25,65628000
soulcutter,62867000,54073000,58741671,54156800,22,15,8794000,0.16,131910000
souleater (axe),-1,-1,-1,-1,-1,-1,0,0,0
souleater trophy,3450,3450,8000,3386,1,14,0,0.0,0
soulfire rune,99,30,87,17,270,112,69,2.3,7728
soulful legs,222079,181187,294866,240300,132,125,40892,0.23,5111500
soulhexer,200100,170002000,196095888,185595533,18,15,-169801900,-1.0,-2547028500
soulmaimer,36955000,32009000,35016333,31854500,18,12,4946000,0.15,59352000
soulmantle,46999000,45000000,51212374,47316066,16,15,1999000,0.04,29985000
soulpiercer,67998000,60009000,69872785,65297736,14,19,7989000,0.13,111846000
soulshanks,48413000,44018000,50403900,46698141,20,22,4395000,0.1,87900000
soulshell,94982000,85002000,93847148,87091375,18,16,9980000,0.12,159680000
soulshredder,198240,167026000,185937631,174992545,19,22,-166827760,-1.0,-3169727440
soulshroud,77945000,61006000,67863904,64660644,21,15,16939000,0.28,254085000
soulstrider,90997000,82025000,89062188,82956473,26,19,8972000,0.11,170468000
soultainter,141961,120042000,146989349,139699909,20,22,-119900039,-1.0,-2398000780
spark sphere,899,129,914,276,39,239,770,5.97,30030
sparking rainbow shield,-1,-1,-1,-1,-1,-1,0,0,0
sparkion claw,-1,-1,-1,-1,-1,-1,0,0,0
sparkion legs,222,222,0,217,0,62,0,0.0,0
sparkion stings,210,210,0,206,0,77,0,0.0,0
sparkion tail,210,210,0,206,0,69,0,0.0,0
spear,1490000,800000,1892571,800000,7,1,690000,0.86,690000
special flask (fools guild),-1,-1,-1,-1,-1,-1,0,0,0
special flask (holy water),-1,-1,-1,-1,-1,-1,0,0,0
special flask (padreia),-1,-1,-1,-1,-1,-1,0,0,0
special flask (quara),-1,-1,-1,-1,-1,-1,0,0,0
special flask (slime),-1,-1,-1,-1,-1,-1,0,0,0
special flask (stalker),-1,-1,-1,-1,-1,-1,0,0,0
special polish,-1,0,0,0,0,0,-1,0,0
spectral bolt,72,69,71,66,1759,214,3,0.04,642
spectral cloth,5999,0,7899,0,1,0,5999,0,0
spectral dress,29000,0,28000,0,4,0,29000,0,0
spectral gold nugget,1000,1000,0,404,0,7,0,0.0,0
spectral horse tack,20001000,20001000,28698249,17001000,8,3,0,0.0,0
spectral horseshoe,9899999,8005000,8468036,6638500,26,12,1894999,0.24,22739988
spectral saddle,25989999,15600000,25030093,15600036,8,3,10389999,0.67,31169997
spectral scrap of cloth,949900,302700,376083,264896,81,49,647200,2.14,31712800
spectral silver nugget,0,110,0,155,0,9,-110,-1.0,0
spectral stone,0,0,0,0,0,0,0,0,0
spellbook,207900,146005,215137,136669,15,11,61895,0.42,680845
spellbook (alternative),-1,-1,-1,-1,-1,-1,0,0,0
spellbook of ancient arcana,3997999,3403000,3822065,3224661,63,51,594999,0.17,30344949
spellbook of dark mysteries,99986,58511,136511,95020,166,126,41475,0.71,5225850
spellbook of enlightenment,4299,3643,4110,3638,114,709,656,0.18,74784
spellbook of lost souls,18600,14558,24616,17311,44,215,4042,0.28,177848
spellbook of mind control,12673,12381,13290,12277,151,974,292,0.02,44092
spellbook of vigilance,2300,301,2871,320,88,68,1999,6.64,135932
spellbook of warding,8700,7264,8212,7343,73,1098,1436,0.2,104828
spellscroll of prophecies,8987,4000,17592,4055,39,33,4987,1.25,164571
spellsinger's seal,-1,-1,-1,-1,-1,-1,0,0,0
spellwand,1889,424,1144,496,231,37,1465,3.46,54205
spellweaver's robe,12900,11433,12012,11374,22,699,1467,0.13,32274
sphinx feather,499,331,911,327,86,449,168,0.51,14448
sphinx tiara,299,213,477,262,4,464,86,0.4,344
spider fangs,-1,1,463,3,7,381,-2,-2.0,-14
spider silk,1854,1724,1989,1675,324,1448,130,0.08,42120
spiderwebs,149999,9240,114002,16378,13,3,140759,15.23,422277
spidris mandible,152,152,0,226,0,16,0,0.0,0
spike shield,102,237,40,100,234,102,-135,-0.57,-13770
spike sword,50,50,0,0,0,0,0,0.0,0
spiked iron ball,98,77,91,73,9,325,21,0.27,189
spiked squelcher,5790,4935,5836,4904,4,1663,855,0.17,3420
spiky club,105,285,20,103,250,105,-180,-0.63,-18900
spirit cage,0,3500,0,3500,0,3,-3500,-1.0,0
spirit cloak,250,138,458,121,140,339,112,0.81,15680
spirit container,68440,38700,51425,37811,98,60,29740,0.77,1784400
spirit guide,1971992,1708200,2144324,1797421,64,46,263792,0.15,12134432
spiritthorn armor,265882,235000000,277325095,255087888,21,18,-234734118,-1.0,-4225214124
spiritthorn helmet,227984,200152000,241474636,220231636,22,11,-199924016,-1.0,-2199164176
spiritthorn ring,160999,151000000,171136789,162351583,19,12,-150839001,-1.0,-1810068012
spiritual charm,79997,41524,89316,46525,220,78,38473,0.93,3000894
spite's spirit,685000,685000,0,535020,0,6,0,0.0,0
spitter nose,-1,-1,-1,-1,-1,-1,0,0,0
spooky blue eye,200,26,200,5,1,8,174,6.69,174
spooky hood,3888,480,9910,336,42,20,3408,7.1,68160
spool of yarn,22998,19095,27903,22562,171,42,3903,0.2,163926
spoon,400,14,1304,11,138,27,386,27.57,10422
spoon with a ribbon,140000,10000,140000,10000,1,1,130000,13.0,130000
springsprout rod,3531,3391,3521,3352,140,3193,140,0.04,19600
sprocketwhip cone,-1,0,0,0,0,0,-1,0,0
spying eye,69900,33092,71475,35602,62,52,36808,1.11,1914016
spyreport,-1,0,0,0,0,0,-1,0,0
square table kit,100000,100000,0,0,0,0,0,0.0,0
squeezing gear of girlpower,646739,403042,504423,420849,339,268,243697,0.6,65310796
squeezing gear of girlpower (jammed),-1,-1,-1,-1,-1,-1,0,0,0
srezz' eye,2796,100,2797,186,10,36,2696,26.96,26960
stabilizer,100000,0,58300,0,5,0,100000,0,0
staff,8000,7901,8070,7898,12,919,99,0.01,1188
staff (simon),-1,-1,-1,-1,-1,-1,0,0,0
stalagmite rune,-1,1,9,4,11,19,-2,-2.0,-22
stalagmite rune (weak),-1,-1,-1,-1,-1,-1,0,0,0
stale bread of ancientness,1000,1000,0,1000,0,1,0,0.0,0
stamina extension,8000000,6000002,7295795,5848208,71,23,1999998,0.33,45999954
stamped parcel,350,0,100,0,4,0,350,0,0
stampor horn,6999,2222,6287,1857,27,37,4777,2.15,128979
stampor talons,499,101,683,74,18,43,398,3.94,7164
star amulet,998,20,5197,11,5,25,978,48.9,4890
star herb,18,8,43,8,22,21,10,1.25,210
star ring,58335,3048,57542,2669,7,4,55287,18.14,221148
starfish (item),-1,-1,-1,-1,-1,-1,0,0,0
starlight vial,6638,4005,7130,3695,211,118,2633,0.66,310694
statue of abyssador,1000,1000,0,1000,0,2,0,0.0,0
statue of deathstrike,30000,900,35000,900,1,2,29100,32.33,29100
statue of devovorga,445,445,0,423,0,114,0,0.0,0
statue of gnomevil,3000,750,3000,791,2,6,2250,3.0,4500
stealth ring,1000,655,860,634,5160,2165,345,0.53,746925
steel axe,13999,100,11749,100,4,1,13899,138.99,13899
steel boots,34897,29930,33109,29865,73,1165,4967,0.17,362591
steel helmet,2299994,302000,2322497,0,4,0,1997994,6.62,0
steel shield,76,34,69,25,10,134,42,1.24,420
stitched mutant hide legs,70000000,30000000,70000000,0,1,0,40000000,1.33,0
stockfish,-1,0,0,0,0,0,-1,0,0
stolen golden goblet,20000,20000,0,0,0,0,0,0.0,0
stone herb,120,10,47,10,3,29,110,11.0,330
stone nose,161,161,0,160,0,11,0,0.0,0
stone of insight,275000,275000,351229,283582,23,42,0,0.0,0
stone of wisdom,1115500,1115500,0,0,0,0,0,0.0,0
stone shower rune,38,36,37,36,739,214,2,0.06,428
stone shower rune (weak),-1,-1,-1,-1,-1,-1,0,0,0
stone skin amulet,5455,5080,5526,5018,3919,2557,375,0.07,958875
stone table kit,100000,100000,0,0,0,0,0,0.0,0
stone wing,200,100,200,86,1,173,100,1.0,100
stonecutter axe,199900,154000,188838,130888,28,20,45900,0.3,918000
stonerefiner's skull,90,84,86,75,7,410,6,0.07,42
strand of medusa hair,1483,1028,2203,1589,1102,686,455,0.44,312130
strange helmet,554,315,437,290,30,266,239,0.76,7170
strange mallet,1500000,1500000,0,0,0,0,0,0.0,0
strange powder,67000,0,67000,0,1,0,67000,0,0
strange proto matter,500,500,0,500,0,1,0,0.0,0
strange symbol,180,75,198,90,1,219,105,1.4,105
strange talisman,-1,1,31,3,70,275,-2,-2.0,-140
strawberry,-1,1,99,1,2,7,-2,-2.0,-4
strawberry cupcake,1417904,1038100,1521253,1233885,121,72,379804,0.37,27345888
streaked devourer eyes,166,166,0,358,0,11,0,0.0,0
streaked devourer legs,200,200,0,463,0,8,0,0.0,0
streaked devourer maw,133,133,0,195,0,8,0,0.0,0
strike enhancement,1244444,900008,1150067,887540,39,25,344436,0.38,8610900
striker's favourite pillow,0,0,0,0,0,0,0,0,0
string of mending,3500000,711000,1511918,1088734,15,9,2789000,3.92,25101000
striped fur,49,15,79,30,11,200,34,2.27,374
strong health potion,23,13,31,20,1577,2130,10,0.77,15770
strong mana potion,95,93,94,92,6124,1645,2,0.02,3290
strong sinew,7500,11,8000,10,1,2,7489,680.82,7489
studded armor,-1,5,0,5,0,11,-6,-1.2,0
studded club,-1,0,1,0,2,0,-1,0,0
studded helmet,-1,3,1,3,1,15,-4,-1.33,-4
studded legs,-1,4,0,4,0,16,-5,-1.25,0
studded shield,-1,3,0,3,0,13,-4,-1.33,0
stuffed bunny,6777,19000,0,19000,0,1,-12223,-0.64,0
stuffed toad,1999800,1351000,1999650,1351500,2,2,648800,0.48,1297600
sturdy book,8899000,6600000,10274750,6900571,4,7,2299000,0.35,9196000
sudden death rune,137,133,136,133,6294,957,4,0.03,3828
sudden death rune (weak),-1,-1,-1,-1,-1,-1,0,0,0
sugar oat,120,999,30,26,804,400,-879,-0.88,-351600
sulphurous demonbone,124600,65000,209900,92500,1,2,59600,0.92,59600
sulphurous stone,87,61,95,60,4,356,26,0.43,104
summer dress,6997,500,6429,504,20,20,6497,12.99,129940
summerblade,639300,500000,636938,558991,64,54,139300,0.28,7522200
sun catcher,19989,8628,10429,7158,436,221,11361,1.32,2510781
sun fruit,40,0,40,0,44,0,40,0,0
sun medal,5995,1,8873,363,4,8,5994,5994.0,23976
sun mirror,30001000,30001000,0,0,0,0,0,0.0,0
sunray emblem,20000,1,14602,528,7,4,19999,19999.0,79996
supreme health potion,654,621,656,621,1639,2974,33,0.05,54087
surprise bag (blue),-1,-1,-1,-1,-1,-1,0,0,0
surprise bag (red),-1,-1,-1,-1,-1,-1,0,0,0
surprise bag (yellow),-1,-1,-1,-1,-1,-1,0,0,0
surprise cube,435000,177777,448111,0,3,0,257223,1.45,0
surprise jar,28899,16928,26244,17004,25,4,11971,0.71,47884
surprise nest,17999,11,27644,11,2,1,17988,1635.27,17988
suspicious device,16860,14305,18255,15419,601,461,2555,0.18,1177855
suspicious documents,-1,0,0,0,0,0,-1,0,0
suspicious signet ring,-1,0,0,0,0,0,-1,0,0
suspicious surprise bag,500,500,8184,500,3,1,0,0.0,0
swamp grass,120,12,192,16,40,143,108,9.0,4320
swamplair armor,16900,15680,16596,15642,4,146,1220,0.08,4880
swampling club,100,9,100,11,1,93,91,10.11,91
swampling moss,20,1,899,4,3,141,19,19.0,57
swan feather,1048,12,916,278,72,21,1036,86.33,21756
swan feather cloak,659999,605257,882043,700533,148,129,54742,0.09,7061718
swarmer antenna,188,43,249,75,1,68,145,3.37,145
sweet and sugary substance,0,1,0,1,0,2,-1,-1.0,0
sweet mangonaise elixir,709992,600503,697472,601996,63,29,109489,0.18,3175181
sweet smelling bait,333333,180700,264272,186211,28,8,152633,0.84,1221064
sweetheart ring,14376,101,5084,41,41,34,14275,141.34,485350
sword,7500,5921,10057,5921,23,21,1579,0.27,33159
sword ring,199,103,222,111,1528,1036,96,0.93,99456
table lamp kit,100000,100000,0,0,0,0,0,0.0,0
tactical map,-1,10000,0,10000,0,1,-10001,-1.0,0
tagralt blade,58000,10005,66709,29021,74,39,47995,4.8,1871805
tagralt-inlaid scabbard,1444435,750000,1162500,775000,4,2,694435,0.93,1388870
tail of abyssador,1000,400,999,346,2,43,600,1.5,1200
tail of corruption,191,191,0,140,0,22,0,0.0,0
tainted glooth capsule,149,15,203,31,21,95,134,8.93,2814
talon,10000,1400,8496,1400,7,7,8600,6.14,60200
tanjis' sight,18998000,18000000,18998000,15000000,1,1,998000,0.06,998000
tarantula egg,80,48,107,54,13,349,32,0.67,416
tarnished rhino figurine,1199,106,1199,197,1,33,1093,10.31,1093
tarsal arrow,-1,1,7,1,145,67,-2,-2.0,-134
tattered piece of robe,40,40,0,49,0,8,0,0.0,0
tattered swan feather,455,455,0,400,0,2,0,0.0,0
tatty dragon scale legs,248,44,695,44,12,8,204,4.64,1632
taurus mace,470,272,438,295,28,341,198,0.73,5544
tear of daraman,-1,0,0,0,0,0,-1,0,0
tearesa,202700,29000,164165,29840,4,5,173700,5.99,694800
technomancer beard,34999,1111,26645,1111,23,1,33888,30.5,33888
teddy bear,556000,1000000,625000,1000000,2,1,-444000,-0.44,-444000
teleport crystal,119999,44222,103848,44127,36,9,75777,1.71,681993
teleportation rod,-1,-1,-1,-1,-1,-1,0,0,0
telescope eye,1101,1101,0,1100,0,8,0,0.0,0
telescope kit,100000,100000,0,0,0,0,0,0.0,0
tempest shield,48465000,42500000,46731500,42000922,2,4,5965000,0.14,11930000
templar scytheblade,2000,0,1708,0,6,0,2000,0,0
tentacle of tentugly,86000,18001,99999,16782,1,4,67999,3.78,67999
tentacle piece,20000,15001,38851,21353,102,88,4999,0.33,439912
tentugly's eye,42238,42238,0,42235,0,13,0,0.0,0
tentugly's jaws,50124,50124,0,44124,0,1,0,0.0,0
terra amulet,1531,1475,1535,1472,516,3651,56,0.04,28896
terra boots,2495,2470,2462,2432,105,4319,25,0.01,2625
terra helmet,129999,111000,108300,84534,135,92,18999,0.17,1747908
terra hood,2589,2466,2528,2467,78,2992,123,0.05,9594
terra legs,11149,10890,11426,10716,128,2680,259,0.02,33152
terra mantle,11999,10880,12057,10898,98,2387,1119,0.1,109662
terra rod,1942,1767,1966,1827,261,4228,175,0.1,45675
terramite eggs,448,5,498,13,2,18,443,88.6,886
terramite legs,95,16,494,23,2,60,79,4.94,158
terramite shell,63,63,0,118,0,66,0,0.0,0
terran rainbow shield,-1,-1,-1,-1,-1,-1,0,0,0
terrorbird beak,280,1,254,12,11,57,279,279.0,3069
thaian sword,27990,8088,19381,8051,13,6,19902,2.46,119412
the alchemists' formulas,100000,1000,100000,0,1,0,99000,99.0,0
the avenger,41685,36011,48373,35006,26,29,5674,0.16,147524
the calamity,790000,350224,564211,350100,6,1,439776,1.26,439776
the carrot of doom,-1,0,0,0,0,0,-1,0,0
the cobra amulet,29990000,22002000,26841769,22132911,14,5,7988000,0.36,39940000
the crown of the percht queen (fire),50000,10200,52777,8035,2,1,39800,3.9,39800
the crown of the percht queen (ice),50000,10200,52777,8035,2,1,39800,3.9,39800
the devileye,430000,100000000,0,100000000,0,1,-99570000,-1.0,0
the dust of arthei,-1,0,0,0,0,0,-1,0,0
the dust of boreth,0,10000,0,10000,0,1,-10000,-1.0,0
the dust of lersatio,10,10,0,0,0,0,0,0.0,0
the dust of marziel,0,10000,0,10000,0,1,-10000,-1.0,0
the dwarven emperor's beard,-1,0,0,0,0,0,-1,0,0
the epiphany,1500000,1500000,0,0,0,0,0,0.0,0
the famous mina losa painting,0,0,0,0,0,0,0,0,0
the handmaiden's protector,10000,10001,0,10001,0,1,-1,-0.0,0
the head of a jester doll,1000,3000,0,3000,0,1,-2000,-0.67,0
the heart of the sea,-1,0,0,0,0,0,-1,0,0
the imperor's trident,239997,10001,249600,10001,1,1,229996,23.0,229996
the ironworker,119700,70600,133106,83706,3,3,49100,0.7,147300
the justice seeker,52000,24100,43840,30513,28,17,27900,1.16,474300
the lethal lissy's shirt,799996,500023,648771,503758,9,8,299973,0.6,2399784
the lion's heart,76350,57935,74625,59543,24,6,18415,0.32,110490
the lower left part of a map,-1,10000,0,10000,0,1,-10001,-1.0,0
the lower right part of a map,-1,10000,0,10000,0,1,-10001,-1.0,0
the mexcalibur (replica),-1,-1,-1,-1,-1,-1,0,0,0
the plasmother's remains,150000,150000,0,0,0,0,0,0.0,0
the regalia of suon,169000,101496,174236,104831,2,3,67504,0.67,135008
the ring of the count,0,0,0,0,0,0,0,0,0
the rite of eternal night,-1,10000,0,10000,0,1,-10001,-1.0,0
the skull of a beast,33005000,33005000,40299795,29261500,10,2,0,0.0,0
the stomper,1449988,787000,1498000,0,1,0,662988,0.84,0
the tail of the keeper,1112,1112,0,0,0,0,0,0.0,0
the top left part of a map,-1,10000,0,10000,0,1,-10001,-1.0,0
the top right part of a map,-1,10000,0,10000,0,1,-10001,-1.0,0
the torso of a jester doll,0,100,0,100,0,1,-100,-1.0,0
the vampire count's medal,2500,2500,0,1106,0,5,0,0.0,0
theatre script,-1,0,0,0,0,0,-1,0,0
theodore loveless' key,-1,0,0,0,0,0,-1,0,0
thick fur,3089,2814,4321,3487,603,719,275,0.1,165825
thorn,160999,151000000,171136789,162351583,19,12,-150839001,-1.0,-1810068012
thorn seed,11110,1200,30000,1208,1,5,9910,8.26,9910
thorn spitter,3374997,2207000,4022128,2552250,6,4,1167997,0.53,4671988
throwing axe,-1,-1,-1,-1,-1,-1,0,0,0
throwing cake,-1,0,0,0,0,0,-1,0,0
throwing knife,15,0,8,0,16,0,15,0,0
throwing star,44,21,41,19,265,329,23,1.1,6095
thunder hammer,182748,150000,150000000,0,1,0,32748,0.22,0
thunderheart cuirass,1499000,1002000,1498700,1001810,4,3,497000,0.5,1491000
thunderheart hauberk,505457,505457,1299993,0,2,0,0,0.0,0
thunderheart platemail,1000000,1000000,0,0,0,0,0,0.0,0
thundermind raiment,749999,652302,816524,589819,32,19,97697,0.15,1856243
thundersoul tabard,598888,526223,602253,500366,6,3,72665,0.14,217995
thunderstorm rune,48,46,47,45,1423,339,2,0.04,678
thunderstorm rune (weak),-1,-1,-1,-1,-1,-1,0,0,0
tiara,2625457,5000000,0,5000000,0,1,-2374543,-0.47,0
tiara of power,69900,48356,83123,56884,525,384,21544,0.45,8272896
tibia coins,28499,27977,27495,26919,8839,14453,522,0.02,4613958
tiger eye,335,335,0,323,0,385,0,0.0,0
time ring,2289,2092,2382,2101,5676,1261,197,0.09,248417
tin key,3600000,1716025,2631246,1703000,5,1,1883975,1.1,1883975
tinged pot,119600,24000,119999,23333,1,3,95600,3.98,95600
titan axe,3900,3503,3875,3582,113,2871,397,0.11,44861
toga mortis,1888877,1116202,1695356,1188581,68,45,772675,0.69,34770375
token of love,589000,388000,629749,389666,4,12,201000,0.52,804000
tomato,18,0,18,0,7,0,18,0,0
tome of knowledge,144890,90317,124190,97570,211,183,54573,0.6,9986859
tonguefruit,-1,0,0,0,0,0,-1,0,0
tooth file,600,1,734,10,5,55,599,599.0,2995
torn incantation fragment,-1,0,0,0,0,0,-1,0,0
torn shirt,-1,-1,-1,-1,-1,-1,0,0,0
torn teddy,149999,15000,285000,0,1,0,134999,9.0,0
torso of abyssador,500,20,1219,353,5,52,480,24.0,2400
torso of deathstrike,-1,-1,-1,-1,-1,-1,0,0,0
torso of gnomevil,-1,-1,-1,-1,-1,-1,0,0,0
tortoise egg,-1,1,139,1,7,2,-2,-2.0,-4
tortoise egg from nargor,-1,0,0,0,0,0,-1,0,0
tortoise shield,230,35,347,35,12,25,195,5.57,2340
tower shield,7899,7682,7859,7627,92,2109,217,0.03,19964
toxic tulip seed,-1,300,0,300,0,2,-301,-1.0,0
toy mouse,5000,100,3761,5,9,1,4900,49.0,4900
traditional stein,-1,-1,-1,-1,-1,-1,0,0,0
trap,199,0,772,0,12,0,199,0,0
trapped bad dream monster,319,319,0,515,0,44,0,0.0,0
trapped lightning,10334444,15101000,0,15101500,0,2,-4766556,-0.32,0
treader of torment,5400000,9100005,0,9100005,0,1,-3700005,-0.41,0
treasure chest (item),-1,-1,-1,-1,-1,-1,0,0,0
treasure chest (ornamented),-1,-1,-1,-1,-1,-1,0,0,0
treasure map (pirate),-1,-1,-1,-1,-1,-1,0,0,0
tremendous tyrant head,310,801,0,801,0,1,-491,-0.61,0
tremendous tyrant shell,246,641,0,641,0,1,-395,-0.62,0
tribal crest,600000,200101,560000,212725,5,4,399899,2.0,1599596
tribal mask,237,76,226,120,69,300,161,2.12,11109
triple bolt crossbow,4000000,2223000,3288065,2171000,8,1,1777000,0.8,1777000
troll green,100,42,288,39,49,273,58,1.38,2842
trollroot,-1,1,496,11,3,9,-2,-2.0,-6
trophy of feroxa,9888,2,9648,2,6,6,9886,4943.0,59316
trophy of jaul,7400,500,6258,1656,4,16,6900,13.8,27600
trophy of obujos,5000,5000,0,1500,0,4,0,0.0,0
trophy of tanjis,45000,1000,51111,1000,4,8,44000,44.0,176000
trophy stand,287,2,461,2,48,17,285,142.5,4845
tropical fried terrorbird,199980,126244,196429,165960,188,54,73736,0.58,3981744
trough kit,100000,100000,0,0,0,0,0,0.0,0
trousers of the ancients,40000,10000,40000,10000,1,1,30000,3.0,30000
truelove teddy,19999,1011,29840,464,8,7,18988,18.78,132916
trunk chair kit,-1,100000,0,100000,0,1,-100001,-1.0,0
trunk kit,100000,100000,0,0,0,0,0,0.0,0
trunk table kit,100000,100000,0,0,0,0,0,0.0,0
tulip,-1,300,0,300,0,2,-301,-1.0,0
tunic,19,1,34,1,5,7,18,18.0,90
tunnel tyrant head,251,251,0,351,0,8,0,0.0,0
tunnel tyrant shell,351,351,0,469,0,7,0,0.0,0
turquoise fireworks powder,210,14,1055,9,27,53,196,14.0,5292
turquoise fireworks rocket,-1,-1,-1,-1,-1,-1,0,0,0
turquoise tendril lantern,4254,130,4112,535,53,44,4124,31.72,181456
turtle amulet,53400000,46022000,51018043,46069916,18,12,7378000,0.16,88536000
turtle shell,23999,16514,19951,16465,324,491,7485,0.45,2425140
tusk,95,42,223,57,4,274,53,1.26,212
tusk chair kit,100000,100000,0,0,0,0,0,0.0,0
tusk shield,700,361,749,375,6,177,339,0.94,2034
tusk table kit,100000,100000,0,0,0,0,0,0.0,0
twiceslicer,27500,27280,33046,26379,10,184,220,0.01,2200
twin axe,1925524,1925524,0,0,0,0,0,0.0,0
twin hooks,447,235,387,225,36,586,212,0.9,7632
twin sun charm,211100,88100,154463,108373,204,86,123000,1.4,10578000
two handed sword,533,222,403,245,38,571,311,1.4,11818
ultimate healing rune (item weak),-1,-1,-1,-1,-1,-1,0,0,0
ultimate healing rune (item),-1,-1,-1,-1,-1,-1,0,0,0
ultimate health potion,355,325,327,296,2020,5568,30,0.09,60600
ultimate mana potion,441,435,443,433,6311,2946,6,0.01,17676
ultimate spirit potion,441,421,440,429,1056,2739,20,0.05,21120
umbral axe,97900,27928,49020,28447,7,4,69972,2.51,279888
umbral blade,54974,21995,72675,20197,6,8,32979,1.5,197874
umbral bow,89727,34695,42609,19064,23,16,55032,1.59,880512
umbral chopper,59900,20000,94794,14825,2,3,39900,2.0,79800
umbral crossbow,77499,53000,79655,49801,5,7,24499,0.46,122495
umbral hammer,17000,5402,16570,7623,5,5,11598,2.15,57990
umbral mace,64300,11900,80738,16494,5,7,52400,4.4,262000
umbral master axe,1598986,1050000,1448004,1050000,4,1,548986,0.52,548986
umbral master bow,2693000,1615000,2518443,2059868,10,6,1078000,0.67,6468000
umbral master chopper,3715000,3302011,3961161,3333376,6,8,412989,0.13,2477934
umbral master crossbow,4199991,2859005,4327473,3424429,21,14,1340986,0.47,18773804
umbral master hammer,3700400,3004000,3826913,2664696,7,5,696400,0.23,3482000
umbral master mace,1449600,1022462,1532220,1213962,4,2,427138,0.42,854276
umbral master slayer,1800000,900000,1749997,966670,3,3,900000,1.0,2700000
umbral master spellbook,9493000,8502000,10710019,9129934,74,56,991000,0.12,55496000
umbral masterblade,1224000,1900416,0,2000208,0,2,-676416,-0.36,0
umbral slayer,34889,4900,62298,7603,3,6,29989,6.12,89967
umbral spellbook,207900,146005,215137,136669,15,11,61895,0.42,680845
undead heart,-1,-1,-1,-1,-1,-1,0,0,0
underworld rod,4350,4159,4366,4195,197,3590,191,0.05,37627
unholy bone,550,424,624,409,2,234,126,0.3,252
unicorn figurine,79900,48300,79993,41125,1,4,31600,0.65,31600
unicorn weisswurst,100000,100000,0,60000,0,1,0,0.0,0
unity charm,187770,86066,154006,69466,183,48,101704,1.18,4881792
universal tool,3300,45,2417,45,119,6,3255,72.33,19530
unliving demonbone,1999500,1500100,2979400,1500900,5,3,499400,0.33,1498200
unrealized dream,49905,31200,55780,33568,182,122,18705,0.6,2282010
unworked sacred wood,-1,0,85000,0,3,0,-1,0,0
urmahlullu's mane,474800,474800,0,476244,0,38,0,0.0,0
urmahlullu's paw,236700,236700,0,236678,0,105,0,0.0,0
urmahlullu's tail,208499,203700,207458,201636,7,139,4799,0.02,33593
utua's poison,1399,101,1700,117,3,32,1298,12.85,3894
valentine's cake,499,2,678,2,5,6,497,248.5,2485
valuable carving axe,0,0,0,0,0,0,0,0,0
valuable carving blade,18000,0,18888,0,1,0,18000,0,0
valuable carving chopper,0,0,0,0,0,0,0,0,0
valuable carving hammer,-1,0,0,0,0,0,-1,0,0
valuable carving mace,-1,0,0,0,0,0,-1,0,0
valuable carving rod,-1,0,30000,0,2,0,-1,0,0
valuable carving slayer,-1,0,0,0,0,0,-1,0,0
valuable carving wand,0,0,0,0,0,0,0,0,0
valuable mayhem axe,-1,0,0,0,0,0,-1,0,0
valuable mayhem blade,0,0,0,0,0,0,0,0,0
valuable mayhem chopper,-1,0,0,0,0,0,-1,0,0
valuable mayhem hammer,-1,0,0,0,0,0,-1,0,0
valuable mayhem mace,-1,0,0,0,0,0,-1,0,0
valuable mayhem rod,-1,0,20000,0,1,0,-1,0,0
valuable mayhem slayer,-1,0,0,0,0,0,-1,0,0
valuable mayhem wand,-1,0,25000,0,2,0,-1,0,0
valuable remedy axe,-1,0,0,0,0,0,-1,0,0
valuable remedy blade,-1,0,0,0,0,0,-1,0,0
valuable remedy chopper,0,0,0,0,0,0,0,0,0
valuable remedy hammer,-1,0,0,0,0,0,-1,0,0
valuable remedy mace,-1,0,0,0,0,0,-1,0,0
valuable remedy rod,-1,0,0,0,0,0,-1,0,0
valuable remedy slayer,10000,0,20000,0,1,0,10000,0,0
valuable remedy wand,-1,0,0,0,0,0,-1,0,0
valuable vase,-1,10000,0,10000,0,1,-10001,-1.0,0
vampire doll,500000,3925457,0,3925457,0,1,-3425457,-0.87,0
vampire dust,3281,1801,3457,2768,394,165,1480,0.82,244200
vampire lord token,781299,350306,641977,462156,34,13,430993,1.23,5602909
vampire shield,16999,14245,17741,14267,129,291,2754,0.19,355266
vampire silk slippers,19890000,15007000,19889500,17003500,2,2,4883000,0.33,9766000
vampire teeth,1361,1295,1668,1480,2289,902,66,0.05,59532
vampire's cape chain,400,85,862,91,6,88,315,3.71,1890
vampire's signet ring,280000,280000,610400,0,3,0,0,0.0,0
vampiric crest,398800,222400,453308,238366,5,6,176400,0.79,882000
varnished diremaw brainpan,250,651,0,651,0,2,-401,-0.62,0
varnished diremaw legs,223,351,0,351,0,4,-128,-0.36,0
vase,64,64,0,87,0,44,0,0.0,0
veal,-1,0,0,0,0,0,-1,0,0
veggie casserole,18380,12610,19767,11783,90,42,5770,0.46,242340
vein of ore,312,177,313,170,2,109,135,0.76,270
velvet mantle,64783,28000,66075,28624,4,9,36783,1.31,147132
velvet tapestry,-1,-1,-1,-1,-1,-1,0,0,0
venison,49,1,49,1,1,30,48,48.0,48
venorean cabinet kit,100000,100000,0,0,0,0,0,0.0,0
venorean drawer kit,-1,0,0,0,0,0,-1,0,0
venorean wardrobe kit,-1,0,0,0,0,0,-1,0,0
versicolour fireworks powder,243,16,858,11,53,59,227,14.19,12031
very old piece of paper,24790,15801,46843,19538,29,14,8989,0.57,125846
vexclaw talon,1199,1105,1846,1412,1921,315,94,0.09,29610
vial,395,205,404,241,35,187,190,0.93,6650
vial of hatred,588000,707000,0,1138000,0,3,-119000,-0.17,0
vial of mushroom distillate,-1,0,0,0,0,0,-1,0,0
vibrant egg,2599000,2007000,2929498,2328243,32,29,592000,0.29,17168000
vibrant heart,700,1651,0,1651,0,1,-951,-0.58,0
vibrant robe,400,901,0,901,0,1,-501,-0.56,0
viking helmet,18,18,50,15,1,22,0,0.0,0
viking shield,90000,0,50149,0,2,0,90000,0,0
vile axe,34797,29580,38457,29494,15,246,5217,0.18,78255
violet crystal shard,1753,1482,2350,1464,1,1354,271,0.18,271
violet gem,10198,9925,9903,9913,14,2829,273,0.03,3822
violet glass plate,2300,1517,2379,1415,35,119,783,0.52,27405
viper star,10,1,16,7,60,202,9,9.0,540
visage of the end days,5400000,5400000,0,0,0,0,0,0.0,0
void boots,15500,12152,15649,10340,1198,674,3348,0.28,2256552
volatile proto matter,223,223,0,214,0,71,0,0.0,0
voltage armor,30000,11000,30000,36250,1,6,19000,1.73,19000
voluminous piece of cloth,1400,200,1832,59,69,35,1200,6.0,42000
vortex bolt,-1,1,6,2,67,77,-2,-2.0,-134
wailing widow's necklace,3000,2435,2899,2396,16,118,565,0.23,9040
waldo's post horn,-1,0,0,0,0,0,-1,0,0
wall mirror (edged),-1,-1,-1,-1,-1,-1,0,0,0
wall mirror (oval),-1,-1,-1,-1,-1,-1,0,0,0
wall mirror (round),-1,-1,-1,-1,-1,-1,0,0,0
walnut,199,2,398,38,3,19,197,98.5,591
wand of carving,-1,-1,-1,-1,-1,-1,0,0,0
wand of cosmic energy,1929,1676,1881,1699,414,3257,253,0.15,104742
wand of decay,997,835,948,833,196,938,162,0.19,31752
wand of defiance,6429,5497,6310,5494,196,1395,932,0.17,182672
wand of destruction,469996,330494,713947,468556,36,28,139502,0.42,3906056
wand of dimensions,12000000,3150000,7491091,3033333,5,3,8850000,2.81,26550000
wand of draconia,1439,1151,1387,1208,255,2275,288,0.25,73440
wand of dragonbreath,220,51,193,48,221,409,169,3.31,37349
wand of everblazing,5995,5470,5878,5297,107,508,525,0.1,56175
wand of inferno,2856,2663,2859,2639,410,4792,193,0.07,79130
wand of mayhem,-1,-1,-1,-1,-1,-1,0,0,0
wand of remedy,-1,-1,-1,-1,-1,-1,0,0,0
wand of starstorm,3100,3006,3422,3116,308,4114,94,0.03,28952
wand of voodoo,4100,4052,4263,4021,348,3931,48,0.01,16704
wand of vortex,1499,30,2352,46,20,128,1469,48.97,29380
war axe,50,50,0,0,0,0,0,0.0,0
war crystal,1096,686,1188,535,239,104,410,0.6,42640
war drum,214,1,284,1,6,20,213,213.0,1278
war hammer,39999,50,39999,0,1,0,39949,798.98,0
war horn,10990,7302,16962,7384,19,305,3688,0.51,70072
warlord sword,999999,999999,0,0,0,0,0,0.0,0
warmaster's wristguards,300,165,494,165,41,151,135,0.82,5535
warrior helmet,4998,4515,4910,4648,189,2774,483,0.11,91287
warrior's axe,10979,10090,10834,9875,70,855,889,0.09,62230
warrior's shield,8900,8350,8532,8087,27,676,550,0.07,14850
warsinger bow,195000,139100,172360,131438,59,47,55900,0.4,2627300
warwolf fur,898,10,748,21,13,50,888,88.8,11544
waspoid claw,108,108,0,194,0,36,0,0.0,0
waspoid wing,3396,2900,3956,2328,272,199,496,0.17,98704
watch,340,2310,0,2382,0,5,-1970,-0.85,0
water pipe,-1,0,0,0,0,0,-1,0,0
water pipe (deluxe),-1,-1,-1,-1,-1,-1,0,0,0
waterball,1788,1,1789,1,3,4,1787,1787.0,5361
watering can,187,0,197,0,5,0,187,0,0
watermelon tourmaline (pear),-1,-1,-1,-1,-1,-1,0,0,0
watermelon tourmaline (slice),-1,-1,-1,-1,-1,-1,0,0,0
waterskin,200000,1000,243750,0,4,0,199000,199.0,0
wealth duplex,2194994,1714000,2054931,1759334,35,30,480994,0.28,14429820
weapon matrix crystal,10000,0,25000,0,2,0,10000,0,0
weapon rack kit,100000,100000,0,0,0,0,0,0.0,0
weapons crate,-1,0,0,0,0,0,-1,0,0
weapons crate (set),-1,-1,-1,-1,-1,-1,0,0,0
weaver's wandtip,245,83,241,175,10,266,162,1.95,1620
wedding outfit box,24000,502,20434,443,11,4,23498,46.81,93992
wedding ring,-1,0,0,0,0,0,-1,0,0
werebadger claws,169,125,171,108,11,646,44,0.35,484
werebadger skull,194,154,249,149,7,671,40,0.26,280
werebadger trophy,8800,8317,8772,8044,8,230,483,0.06,3864
werebear fur,259,158,508,154,12,537,101,0.64,1212
werebear skull,250,135,230,143,6,499,115,0.85,690
werebear trophy,10900,9636,10670,9435,16,181,1264,0.13,20224
wereboar hooves,280,188,544,187,155,538,92,0.49,14260
wereboar loincloth,858,858,1334,1125,125,896,0,0.0,0
wereboar trophy,9998,8221,9764,8666,16,188,1777,0.22,28432
wereboar tusks,190,131,174,125,5,589,59,0.45,295
werefox tail,158,158,688,135,3,527,0,0.0,0
werefox trophy,8791,8136,8746,8091,8,165,655,0.08,5240
werehyaena nose,219,151,197,198,14,1136,68,0.45,952
werehyaena talisman,358,138,314,278,4,578,220,1.59,880
werehyaena trophy,11686,9137,11460,10299,38,732,2549,0.28,96862
werewolf amulet,2998,2449,3033,2485,333,775,549,0.22,182817
werewolf fangs,200,137,170,124,11,501,63,0.46,693
werewolf fur,316,316,383,310,4,494,0,0.0,0
werewolf helmet,25300000,9501003,14370604,10361029,18,15,15798997,1.66,236984955
whacking driller of fate,590000,445014,491492,376622,146,103,144986,0.33,14933558
whacking driller of fate (jammed),-1,-1,-1,-1,-1,-1,0,0,0
whisper moss,0,1,0,1,0,1,-1,-1.0,0
white deer antlers,380,300,360,260,8,132,80,0.27,640
white deer skin,700,146,283,138,10,135,554,3.79,5540
white dress,-1,0,0,0,0,0,-1,0,0
white flower,3333,3333,0,0,0,0,0,0.0,0
white gem,11900,11442,11967,11434,20,565,458,0.04,9160
white mushroom,-1,1,7,1,185,71,-2,-2.0,-142
white pearl,160,157,161,136,67,859,3,0.02,201
white piece of cloth,872,312,1027,656,198,313,560,1.79,110880
white raven kit,5000000,12001000,0,12001500,0,2,-7001000,-0.58,0
white silk flower,10497,8427,10347,8447,40,190,2070,0.25,82800
white tapestry,120,1,97,1,56,13,119,119.0,1547
whoopee cushion,-1,0,0,0,0,0,-1,0,0
widow's mandibles,95,74,102,71,8,115,21,0.28,168
wild flowers,81,81,182,79,8,114,0,0.0,0
wild growth rune,144,120,162,114,570,136,24,0.2,3264
wimp tooth chain,40,40,372,44,4,35,0,0.0,0
windborn colossus armor,350200,350200,238475,191300,4,2,0,0.0,0
winged backpack,70000,34511,86726,45627,81,44,35489,1.03,1561516
winged boots,16500,10713,21703,14503,117,116,5787,0.54,671292
winged helmet,300,1,700,1,1,1,299,299.0,299
winged tail,770,556,758,572,6,320,214,0.38,1284
winning lottery ticket,170000,23419,39087,20733,56,18,146581,6.26,2638458
winter wolf fur,6143,5769,6477,5688,658,909,374,0.06,246092
winterberry liquor,99,1,439,2,4,21,98,98.0,392
winterblade,749000,556000,832297,631863,64,61,193000,0.35,11773000
witch broom,100,1,99,12,2,56,99,99.0,198
witch hat,6992,4113,5690,3921,31,47,2879,0.7,89249
witches' cap spot,-1,0,0,0,0,0,-1,0,0
witchesbroom,0,0,0,0,0,0,0,0,0
witchhunter's coat,-1,0,0,0,0,0,-1,0,0
witherblossom,-1,0,0,0,0,0,-1,0,0
withered pauldrons,283,283,0,575,0,3,0,0.0,0
withered scalp,300,300,0,0,0,0,0,0.0,0
wolf backpack,192751,192751,292648,178127,34,25,0,0.0,0
wolf paw,100,24,365,36,140,496,76,3.17,10640
wolf tooth chain,55000,5150,60285,0,7,0,49850,9.68,0
wolf tooth chain (ceiron),-1,-1,-1,-1,-1,-1,0,0,0
wolf trophy,2895,1867,2729,1828,9,202,1028,0.55,9252
wood,57499,39095,46568,35557,170,158,18404,0.47,2907832
wood cape,5049,4793,5053,4746,262,2470,256,0.05,67072
wood mushroom,30,6,29,6,5,91,24,4.0,120
wooden chair kit,-1,0,0,0,0,0,-1,0,0
wooden doll,29999,3,39000,3,1,1,29996,9998.67,29996
wooden flute,100,41,341,41,8,17,59,1.44,472
wooden hammer,-1,0,475,0,2,0,-1,0,0
wooden shield,-1,0,0,0,0,0,-1,0,0
wooden spellbook,11677,11533,12403,11417,92,640,144,0.01,13248
wooden spoon,99,10,99,10,4,24,89,8.9,356
wooden stake,57499,39095,46568,35557,170,158,18404,0.47,2907832
wooden sword,799999,402000,708999,376000,3,4,397999,0.99,1193997
wooden ties,-1,1,1500,1,5,1,-2,-2.0,-2
wooden whistle,2800000,2800000,0,0,0,0,0,0.0,0
wool,1500,1500,5000,1005,1,1,0,0.0,0
worm,276,276,0,224,0,8,0,0.0,0
worm punisher,250,250,0,180,0,4,0,0.0,0
worm queen tooth,13500,2222,14496,0,6,0,11278,5.08,0
worn firewalker boots,139000,85700,124592,87125,13,12,53300,0.62,639600
worn soft boots,418594,361070,440812,387786,86,179,57524,0.16,4947064
wrinkled parchment,-1,0,0,0,0,0,-1,0,0
writhing brain,52000,360900,0,360900,0,1,-308900,-0.86,0
writhing heart,250000,82000,202374,131450,4,2,168000,2.05,336000
wyrm scale,405,361,617,338,289,928,44,0.12,12716
wyvern fang,1592,1435,2014,1423,50,305,157,0.11,7850
wyvern talisman,4458,3909,4586,3273,767,1182,549,0.14,421083
xodet's first wand,0,100000,0,100000,0,1,-100000,-1.0,0
yalahari armor,51195,22222,61187,32268,9,9,28973,1.3,260757
yalahari figurine,21000,21000,0,0,0,0,0,0.0,0
yalahari leg piece,314493,260000,333698,289879,122,98,54493,0.21,5340314
yalahari mask,379591,350000,404044,329884,284,223,29591,0.08,6598793
yellow backpack,67,1,56,9,185,228,66,66.0,12210
yellow bag,800,0,49,0,33,0,800,0,0
yellow bed kit,-1,-1,-1,-1,-1,-1,0,0,0
yellow fireworks powder,154,14,182,10,13,67,140,10.0,1820
yellow fireworks rocket,-1,-1,-1,-1,-1,-1,0,0,0
yellow gem,1000,997,997,991,13,5307,3,0.0,39
yellow piece of cloth,213,122,416,152,120,349,91,0.75,10920
yellow pillow,400,0,400,0,1,0,400,0,0
yellow pillow (supersoft),-1,-1,-1,-1,-1,-1,0,0,0
yellow powder,-1,0,0,0,0,0,-1,0,0
yellow rose,233500,190000000,247410000,202000259,1,3,-189766500,-1.0,-189766500
yellow tapestry,99,1,74,1,2,3,98,98.0,196
yetislippers,690000,400100,570625,334916,17,5,289900,0.72,1449500
yielocks,1500,224,1156,302,3,31,1276,5.7,3828
yielowax,2999,204,7105,454,3,15,2795,13.7,8385
yirkas' egg,500,105,1125,177,2,46,395,3.76,790
yol's bow,30000,30000,0,0,0,0,0,0.0,0
young lich worm,28000,23781,49498,23652,2,130,4219,0.18,8438
yummy gummy worm,886,100,3787,71,5,14,786,7.86,3930
zaoan armor,14000,13330,14077,13050,83,538,670,0.05,55610
zaoan chess box,108944,73633,104892,83741,515,509,35311,0.48,17973299
zaoan halberd,384,151,451,237,11,291,233,1.54,2563
zaoan helmet,46999,44430,50343,44992,490,376,2569,0.06,965944
zaoan legs,13697,13390,14255,13172,727,1044,307,0.02,223189
zaoan robe,12300,11547,14905,11494,29,286,753,0.07,21837
zaoan shoes,5600,4823,5387,4807,162,855,777,0.16,125874
zaoan sword,34491,29681,39540,29612,10,97,4810,0.16,48100
zaogun flag,-1,-1,-1,-1,-1,-1,0,0,0
zaogun shoulderplates,149,53,291,117,8,174,96,1.81,768
